abbe|babe
abed|bead|bade
abel|elba|bale|able|bela
abet|beat|beta|bate
abhorred|harbored
abhorrer|harborer
abides|biased
able|abel|elba|bale|bela
abler|baler|blear|blare
aboard|abroad
abode|adobe
abort|bator
aborted|debator
aborter|roberta
abridge|brigade
abroad|aboard
absorber|reabsorb
abuse|beaus
abuser|bursae
abut|tabu|tuba
accrues|accuser
accuser|accrues
acerbic|breccia
aces|case
ache|each
aches|chase
aching|chiang
ackley|lackey
acme|came|mace
acne|cane
acorns|carson
acre|race|care
acres|races|cares|scare
acrid|radic|dirac
acrostic|socratic
act|cat
acted|cadet
actin|antic
actinide|indicate
action|cation
activate|cavitate
acton|canto
actors|castor|castro
actress|casters|recasts
acts|scat|cats|cast
actuator|autocrat
acuter|curate
ad|da
add|dad
adder|dared|dread
addict|didact
aden|dean|edna|dane
adept|taped|pated
adhere|header
adhered|redhead
adherend|hardened
adheres|headers|sheared
adjuster|readjust
adler|alder
admirer|married
admirers|disarmer
admires|sidearm|misread
admits|amidst
adobe|abode
adore|oared
adorer|roared
adores|soared
adorn|radon
adrian|radian
adroitly|dilatory|idolatry
ads|sad
adsorb|boards
adverse|evaders
advise|davies
adynamic|cyanamid
adze|daze
aery|eyra|year
affair|raffia
afield|failed
afresh|shafer
afro|fora|faro
afters|faster|strafe
aged|egad
ages|sage
agnostic|coatings|coasting
ago|goa
agone|genoa
agree|eager|eagre
agreed|geared
aground|durango
agy|gay
ah|ha
aide|idea
aider|aired
aides|aside|sadie|ideas
aids|dais|said
aileen|elaine
ailments|manliest
ails|lisa|sial|sail
aimed|amide|media
aimer|maier|ramie|marie
aimless|melissa
aims|sima|siam
ain't|anti|tina
air|ira
aired|aider
aires|arise|aries|raise
airless|serials
airman|marina
airmen|marine|remain
airs|sari
aitken|intake
ajar|raja
akers|rakes|asker
akron|koran
alai|alia
alarm|lamar
alarming|marginal
alation|laotian
alberto|latrobe|bloater
alcestis|elastics
alcmena|manacle
alden|laden
alder|adler
ale|lea
alec|lace
alert|later|alter
alerted|altered|related|treadle
alerts|alters|staler|slater
alex|axle|axel
alexander|alexandre
alexandre|alexandre
alfred|flared
alga|gala
algenib|belgian|bengali
alger|large|lager|regal|glare
algeria|regalia
alia|alai
alice|celia
alien|aline
aliens|silane|saline
aligned|leading|dealing
aligner|realign
aligns|signal
aline|alien
allergy|gallery|largely|regally
allot|atoll
allotted|totalled
allows|sallow
alloy|loyal
allure|laurel
alma|lama
alms|slam
alone|leona
alp|lap|pal
alpert|plater
also|laos
altair|atrial|lariat
altars|astral
alter|later|alert
altered|related|treadle|alerted
alterer|relater
alterman|maternal
altern|rental|antler
alters|alerts|staler|slater
altho|loath
alton|tonal|talon
alum|maul
alumna|manual
alums|mauls
alva|lava
alvin|anvil
alyssum|asylums
am|ma
amber|bream
ambling|blaming
amen|name|mane|mean
amenable|nameable
amend|named|maned
amende|demean
amender|meander|renamed
amends|madsen
amenity|anytime
american|cinerama
ames|mesa|same|seam
amherst|hamster
amid|maid
amide|media|aimed
amidst|admits
amino|naomi
among|mango
amortize|atomizer
amos|soma
amp|map|pam
ample|maple
amps|maps
amused|medusa
amuser|maseru
amy|may|yam
an|na
ancestral|lancaster
anchor|rancho|charon
ancients|instance
and|dan
andean|deanna
andersen|ensnared
andes|sedan|deans
andre|arden
andrew|warden|wander|warned
andrews|wardens|wanders
anemic|cinema|iceman
anew|wane|wean
angel|glean|angle|lange|galen
angela|galena
angeles|senegal
angels|gleans|angles
anger|range
angers|ranges
angle|glean|angel|lange|galen
angles|angels|gleans
angriest|granites|gantries
angry|rangy
animal|manila
anise|siena
ann|nan
anna|nana
annale|anneal
anneal|annale
annette|nanette
annie|inane
annum|unman
anoint|nation
ansi|sian
answers|rawness
ant|tan|nat
ante|nate|neat
anted|dante
anteing|gentian|antigen
anthem|hetman
anther|tehran
anti|ain't|tina
antic|actin
antigen|anteing|gentian
antigone|negation
antler|rental|altern
antlers|sternal|rentals
ants|tans|stan
anvil|alvin
any|nay
anytime|amenity
ape|pea
apes|peas|apse
aplastic|capitals
aplenty|penalty
append|napped
appends|snapped
apprise|sappier
apse|apes|peas
apt|pta|pat|tap
aquiline|quiniela
arbiter|rarebit
arc|rca|car
arced|cedar|raced|cadre|cared
arch|char
archaism|charisma
arches|chaser|search
arcs|cars|scar
arden|andre
ardent|ranted
are|era|ear|rae
ares|sear|ears|sera|eras
argon|groan|organ
argot|gator|groat
argue|auger
argues|augers
argus|sugar
arid|raid
aridness|sardines
aries|arise|aires|raise
arise|aries|aires|raise
arisen|arsine
arises|raises
arising|raising
arlen|renal|learn
arm|mar|ram
armada|ramada
armco|marco|macro
armed|dream
armenian|marianne
armfuls|armsful
arming|ingram|margin
armpit|impart
armrest|smarter
armsful|armfuls
army|mary|myra
arnold|roland|ronald
arrest|raters|raster|rarest|starer
arrested|serrated
arrowy|yarrow
arsine|arisen
arson|sonar
art|tar|rat
artemis|smartie
article|recital
articles|recitals
artie|irate
artisan|tsarina
artist|traits|strait
artists|straits|tsarist
arts|tars|star|rats|tsar
arty|tray
aryl|lyra
ascend|dances
ascent|stance|secant|enacts
ascertain|cartesian|sectarian|ascertain
ascot|costa|coast|tacos|coats
ascribed|carbides
ash|has
asher|hears|shear|hares|share
ashley|halsey|shaley
ashman|shaman
ashram|marsha
ashy|shay|hays
aside|sadie|aides|ideas
asides|daises
ask|kas
asker|akers|rakes
askew|wakes
asleep|please|elapse
aspen|napes|panes
aspic|spica
aspirant|partisan
aspirate|parasite
aspire|persia|praise
aspired|diapers|despair|praised
aspirer|repairs|praiser
aspires|praises
astatine|sanitate
aster|rates|stare|tears
astigmat|stigmata
astir|stair|sitar
astm|mast|mats
astor|astro|roast
astral|altars
astro|astor|roast
astute|statue
asylums|alyssum
at|ta
ate|tea|eat|eta
atheists|hastiest
athens|hasten
atingle|genital|gelatin|elating
atoll|allot
atom|moat
atomics|somatic
atomizer|amortize
atone|eaton
atria|tiara
atrial|lariat|altair
attentive|tentative
attic|tacit
attics|static
attune|nutate
attuned|taunted
auction|caution
auger|argue
augers|argues
augment|mutagen
auld|dual|laud
aunt|tuna
aunts|tunas
aural|laura
auric|curia
autoclave|vacuolate
autocrat|actuator
avails|saliva
ave|eva
avenge|geneva
avenger|engrave
avengers|engraves
aventine|venetian
aver|rave|vera
avid|vida|diva
avis|visa|siva
aviv|viva
avocet|vocate|octave
avon|nova
awakener|reawaken
awed|wade
awl|law
awn|wan
awning|waning
awry|wary
axel|axle|alex
axle|alex|axel
ay|ya
aye|yea
ayers|sayer|years
azo|zoa
babbled|blabbed
babbler|blabber
babbling|blabbing
babe|abbe
backward|drawback
bad|dab
bade|bead|abed
badger|garbed|barged
badly|baldy
bads|dabs
bag|gab
bagel|gable
bagels|gables
bail|bali
bails|basil
bake|beak
balancer|barnacle
baldy|badly
bale|abel|elba|able|bela
baleen|enable
baler|blear|blare|abler
bales|basel|sable
bali|bail
balinese|baseline
balm|lamb
balsa|basal
bam|mba
ban|nab
bander|brenda
bandstop|stopband
bane|bean
banter|barnet
barbed|dabber
barcode|brocade
barged|garbed|badger
baric|carib|rabic
baritone|obtainer
barnacle|balancer
barnet|banter
barney|nearby
basal|balsa
based|beads
basel|bales|sable
baseline|balinese
bashaw|wabash
basil|bails
bast|tabs|bats|stab
bastion|obtains
bat|tab
bate|abet|beat|beta
bather|bertha|breath
bathers|breaths
bator|abort
bats|tabs|bast|stab
battle|tablet
battles|tablets
baud|daub
bauds|daubs
baulk|kabul
bawler|warble
bayed|beady
bead|abed|bade
beads|based
beady|bayed
beak|bake
beam|bema
bean|bane
beards|breads
beat|abet|beta|bate
beater|berate|rebate
beaus|abuse
bedim|imbed
bedroom|broomed|boredom
bedsore|sobered
beefier|freebie
been|eben
beets|beset
begin|being|binge
begins|beings
behest|thebes
being|begin|binge
beings|begins
bela|abel|elba|bale|able
belgian|algenib|bengali
belied|edible
bella|label
bellows|boswell
below|elbow|bowel
belts|blest
bema|beam
bengali|algenib|belgian
benton|bonnet
berate|rebate|beater
berated|rebated|debater
berating|rebating
berger|gerber
berglund|lundberg
bergstrom|stromberg
bernardo|dearborn
bertha|breath|bather
beset|beets
best|bets
bestiary|sybarite
bestir|bister|tribes
beta|abet|beat|bate
bets|best
betsy|bytes
bey|bye
bhutan|thuban
biased|abides
bids|dibs
bier|brie
big|gib
bike|kibe
binder|inbred
binge|being|begin
bins|nibs
bipedal|piebald
biplane|plebian
bipolar|parboil
bird|drib
bis|sib
bister|bestir|tribes
bistro|orbits
biter|tiber|tribe
bitnet|bitten
bitten|bitnet
bittern|britten
blabbed|babbled
blabber|babbler
blabbing|babbling
blaming|ambling
blare|baler|blear|abler
blasted|stabled
blaster|stabler
blasting|stabling
blear|baler|blare|abler
blearily|reliably
bleat|table
bleats|tables|stable
bleeps|plebes
blessing|glibness
blest|belts
blinder|brindle
blister|bristle
blisters|bristles
bloater|latrobe|alberto
blobbing|bobbling
blot|bolt
blots|bolts
blotted|bottled
blotter|bottler
blotting|bottling
blubber|bubbler
blue|lube
bluegill|gullible
bluer|ruble|burle
bluest|subtle|sublet|bustle
blunder|bundler
blur|burl
blushes|bushels
board|broad
boarded|roadbed
boarder|broader
boards|adsorb
boast|boats
boater|borate
boathouse|houseboat
boats|boast
bobbling|blobbing
bod|dob
bog|gob
bogota|tobago
bole|lobe|loeb
bolo|lobo
bolster|lobster
bolt|blot
bolts|blots
bonder|borden
bonnet|benton
booger|goober
bookcase|casebook
booker|brooke
booms|bosom
boost|boots
boots|boost
borate|boater
bordello|doorbell
borden|bonder
bore|robe
bored|robed
boredom|broomed|bedroom
bores|robes|sober
bosom|booms
boss|sobs
bosses|obsess
boswell|bellows
bottled|blotted
bottler|blotter
bottling|blotting
boulder|doubler
bounder|rebound
bourn|bruno
bowel|elbow|below
bowels|elbows
bowers|browse
bowes|bowse
bowse|bowes
breads|beards
breakout|outbreak
bream|amber
breath|bertha|bather
breaths|bathers
breccia|acerbic
brenda|bander
bribed|ribbed
briber|ribber
bribing|ribbing
bridal|ribald
brie|bier
brief|fiber|fibre
briefed|fibered|debrief
briefs|fibers
brigade|abridge
brindle|blinder
bristle|blister
bristles|blisters
britten|bittern
broad|board
broader|boarder
broadest|debators
broadside|sideboard
brocade|barcode
broglie|obliger
brooke|booker
broomed|boredom|bedroom
broth|throb
broths|throbs
browse|bowers
bruise|buries|rubies|busier
bruno|bourn
brunt|burnt
brush|shrub
brut|burt
brute|rebut|tuber|buret
brutes|buster|tubers
btu|but|tub
bubbler|blubber
bugle|bulge
bugled|bulged
bugler|burgle
bugling|bulging
builder|rebuild
builders|rebuilds
builtin|inbuilt
bulge|bugle
bulged|bugled
bulging|bugling
bun|nub
bundler|blunder
bunked|debunk
bunkered|debunker
burble|rubble|lubber
burbled|rubbled
burbling|rubbling
burden|unbred|burned
buret|rebut|tuber|brute
burg|grub
burgle|bugler
buries|rubies|bruise|busier
burl|blur
burle|ruble|bluer
burned|burden|unbred
burnt|brunt
bursae|abuser
burse|rebus
burt|brut
bury|ruby
bus|sub
busch|chubs
bush|hubs
bushels|blushes
busier|buries|rubies|bruise
buss|subs
bust|tubs|stub
busted|debuts
buster|brutes|tubers
bustle|subtle|bluest|sublet
busts|stubs
busy|buys
but|btu|tub
butchers|schubert
buys|busy
bye|bey
bytes|betsy
cable|caleb
cabs|scab
cadent|decant
cadet|acted
cadre|cedar|raced|cared|arced
caiman|maniac
cain|inca
calder|cradle
caleb|cable
caliber|calibre
calibre|caliber
caliper|replica
calipers|replicas
calk|lack
calker|clarke
caller|cellar|recall
callers|cellars|recalls
callisto|castillo
calm|clam
calmer|marcel
calvary|cavalry
cam|mac
came|acme|mace
camels|mescal
cameron|romance
camino|monica
camped|decamp
campers|scamper
camps|scamp
cams|scam
can't|cant
canceler|clarence
candide|candied
candied|candide
candle|lanced
candor|conrad|dacron
cane|acne
caned|dance
caner|carne|crane
canister|scantier
cannot|canton|conant
canoe|ocean
canoed|deacon
canoes|oceans
cans|scan
canst|scant
cant|can't
canter|trance|nectar|cretan|recant
cantered|recanted|decanter
cantle|lancet
canto|acton
canton|cannot|conant
cantor|carton|contra
cap|cpa
cape|pace
capella|laplace
caper|recap|pacer
capes|paces|space
capitals|aplastic
capitol|topical|optical
capstan|catnaps
capsular|scapular
caption|pontiac
captor|cartop
car|rca|arc
caracas|cascara
caramel|carmela
carbides|ascribed
care|acre|race
cared|cedar|raced|cadre|arced
carer|racer
cares|races|scare|acres
caress|scares
caret|cater|crate|trace|carte|react
carful|fulcra
cargoes|corsage
carib|baric|rabic
carla|clara
carlyle|clearly
carmela|caramel
carne|crane|caner
caroline|cornelia
carpets|spectra
carrie|racier
carries|scarier
cars|arcs|scar
carson|acorns
carte|cater|crate|caret|trace|react
carted|redact|traced
cartels|clarets|scarlet
cartesian|sectarian|ascertain
carting|tracing|crating
carton|cantor|contra
cartop|captor
carve|crave
carved|craved
carven|cavern|craven
carver|craver
carves|craves
carving|craving
carvings|cravings
cascade|saccade
cascara|caracas
case|aces
casebook|bookcase
casein|incase
cashed|chased
cashes|chases
cashing|chasing
cask|sack
cast|scat|cats|acts
caster|recast|traces|crates|reacts
casters|recasts|actress
castillo|callisto
castle|cleats
castoff|offcast
castor|actors|castro
castro|castor|actors
casual|causal
cat|act
catechism|schematic
cater|crate|caret|trace|carte|react
catered|created|reacted
caterer|terrace|retrace
cathy|yacht
cation|action
catnaps|capstan
cats|scat|acts|cast
cattier|citrate
cattily|tacitly
caul|ucla
causal|casual
cause|sauce
causer|saucer
causes|sauces
caution|auction
cavalry|calvary
caveat|vacate
caveats|vacates
cavern|carven|craven
caviar|variac
cavitate|activate
caw|wac
cedar|raced|cadre|cared|arced
cedars|scared|sacred
ceder|creed
ceil|lice
celandine|decennial
celia|alice
cellar|caller|recall
cellars|callers|recalls
celsius|sluices
censor|crones
censored|seconder
centaurs|recusant|etruscan
center|recent
centroid|doctrine
cents|scent|csnet
cereals|rescale
cereus|recuse|rescue|secure
certify|rectify
cerulean|laurence
cervices|crevices
cession|cosines
cetera|create
cetus|cutes
ceylon|conley
chain|china
chained|echidna
char|arch
charisma|archaism
charles|clasher
charm|march
charmed|marched
charmer|marcher
charon|rancho|anchor
chars|crash
charters|chartres
chartres|charters
charts|starch
chase|aches
chased|cashed
chaser|arches|search
chasers|crashes
chases|cashes
chasing|cashing
chaste|scathe|cheats|sachet
chatter|ratchet
chatters|ratchets
chattier|theatric
cheap|peach
cheat|teach
cheater|teacher|hectare
cheaters|hectares|teachers
cheating|teaching
cheats|scathe|chaste|sachet
checker|recheck
cheeps|speech
chenille|hellenic
chert|retch
chesty|scythe
chiang|aching
chief|fiche
chin|inch
china|chain
chine|niche
chit|itch
choirs|orchis
choker|hocker
chokers|shocker
chopin|phonic
chore|ochre
chose|echos
chou|ouch
chowder|cowherd
christen|snitcher
christian|christina
christina|christian
chubs|busch
churl|lurch
cider|cried|dicer
cilia|iliac
cinders|rescind|discern
cinema|anemic|iceman
cinerama|american
ciphered|decipher
ciphers|spheric
circle|cleric
circles|clerics
cit|tic
citadel|dialect
cited|edict
cities|iciest
citrate|cattier
citric|critic
citrus|rustic|curtis
civet|evict
claimed|decimal|declaim
claimer|miracle|reclaim
clam|calm
clanged|glanced
clanging|glancing
clara|carla
clare|lacer|clear
clarence|canceler
clarets|cartels|scarlet
clarke|calker
clasher|charles
clasped|scalped
clasper|scalper|parcels
clasping|scalping
clasps|scalps
claus|lucas
clean|lance
cleaners|cleanser
cleans|lances
cleanser|cleaners
clear|lacer|clare
cleared|creedal|declare
clearly|carlyle
clears|scaler
cleat|eclat
cleats|castle
cleric|circle
clerics|circles
clients|stencil
climaxes|exclaims
clinker|crinkle
clinkers|crinkles
clio|coil|loci
clipper|cripple
clobber|cobbler
clod|cold
clods|scold|colds
closest|closets
closets|closest
clot|colt
clots|colts
cloture|coulter
cloud|could
clumsy|muscly
coachmen|comanche
coal|cola
coast|costa|tacos|ascot|coats
coasting|coatings|agnostic
coat|taco
coatings|agnostic|coasting
coats|costa|coast|tacos|ascot
coattail|tailcoat
cobbler|clobber
cochrane|encroach
cod|doc
coddles|scolded
code|coed
coder|cored|credo|decor
codes|coeds
codon|condo
coed|code
coeds|codes
coffers|scoffer
cohen|enoch
coif|foci
coil|clio|loci
coiled|docile
coin|icon
coiner|enrico|recoin
coins|icons|scion|sonic
coitally|locality
cola|coal
cold|clod
colds|scold|clods
colitis|solicit
collapse|escallop
collide|collied
collied|collide
colt|clot
colts|clots
comanche|coachmen
combo|coomb
combos|coombs
comedian|demoniac
comics|cosmic
compiled|complied
compiler|complier
complaint|compliant
compliant|complaint
complied|compiled
complier|compiler
conant|cannot|canton
concerti|necrotic
condo|codon
condor|cordon
conduits|discount
cone|once
cones|scone
confrere|enforcer
conical|laconic
conifers|forensic
conked|doneck
conley|ceylon
conrad|candor|dacron
conservation|conversation
conserve|converse
consoles|coolness
construe|recounts|trounces|counters
contains|sanction
contra|carton|cantor
contuses|countess
conversation|conservation
converse|conserve
conveyer|reconvey
cool|loco
coolness|consoles
coomb|combo
coombs|combos
coopers|scooper
coops|scoop
cope|opec
copes|scope|copse|pecos
copse|copes|scope|pecos
copses|scopes
copters|spector
corder|record
cordon|condor
cored|coder|credo|decor
corelate|relocate
cores|corse|score
corey|royce
cork|rock
corked|docker|rocked
corker|rocker
corkers|rockers
corks|rocks
cornelia|caroline
corners|scorner
corns|scorn
corny|crony
coroner|crooner
coroners|crooners
corp|crop
corps|crops
corpses|process
corsage|cargoes
corse|cores|score
corset|escort|sector
corseted|sectored|escorted
corsets|escorts|sectors
coset|escot
cosines|cession
cosmic|comics
cost|scot|cots
costa|coast|tacos|ascot|coats
costal|octals
costing|gnostic
costumer|customer
cotillion|octillion
cots|cost|scot
cougher|goucher
could|cloud
coulter|cloture
counter|trounce|recount
counters|recounts|trounces|construe
countess|contuses
counts|tucson
coups|pocus
course|crusoe|source
coursed|scoured
courser|scourer
courses|sucrose|sources
courted|eductor
couth|touch
coverer|recover
covert|vector
cowers|escrow
cowherd|chowder
cows|scow
coyote|oocyte
cpa|cap
cpu|cup|puc
cradle|calder
crafter|refract
cram|marc
crane|carne|caner
cranston|scranton
crash|chars
crashes|chasers
crate|cater|caret|trace|carte|react
crater|tracer
cratered|terraced|retraced
craters|tracers
crates|recast|traces|caster|reacts
crating|carting|tracing
crave|carve
craved|carved
craven|carven|cavern
craver|carver
craves|carves
craving|carving
cravings|carvings
crawlers|scrawler
crawls|scrawl
cray|racy
creaks|sacker
creams|scream
create|cetera
created|reacted|catered
creation|reaction
creative|reactive
creator|reactor
creators|reactors
credit|direct
credited|directed
creditor|director
credits|directs
credo|coder|cored|decor
credos|scored
creed|ceder
creedal|cleared|declare
creeds|screed
creep|crepe
creeps|crepes
creepy|crepey
creon|crone
crepe|creep
crepes|creeps
crepey|creepy
cretan|trance|canter|nectar|recant
crevices|cervices
cried|cider|dicer
crier|ricer
cries|rices
crimps|scrimp
crimson|microns
crinkle|clinker
crinkles|clinkers
cripple|clipper
critic|citric
critters|restrict|stricter
crocus|succor|occurs
crone|creon
crones|censor
crony|corny
crooner|coroner
crooners|coroners
crop|corp
crops|corps
crosser|scorers
crud|curd
crude|cured
crudest|crusted
cruel|lucre|ulcer
cruelest|lectures
cruelty|cutlery
cruet|cuter|truce|curet
cruiser|curries
crusoe|course|source
crusted|crudest
crustier|recruits
crusty|curtsy
csnet|scent|cents
cued|duce
cuffless|scuffles
cuffs|scuff
cup|cpu|puc
cupfuls|cupsful
cupids|cuspid
cups|cusp
cupsful|cupfuls
curate|acuter
curbs|scrub
curd|crud
curdle|curled
cure|ecru
cured|crude
curer|recur
cures|curse
curet|cruet|cuter|truce
curia|auric
curled|curdle
curries|cruiser
curse|cures
curses|cusser
curtesy|curtsey
curtis|rustic|citrus
curtsey|curtesy
curtsy|crusty
cusp|cups
cuspid|cupids
cusser|curses
cusses|sucess
custer|rectus
customer|costumer
cuter|cruet|truce|curet
cutes|cetus
cutest|cutset
cutesy|cuteys
cuteys|cutesy
cutlery|cruelty
cutlets|scuttle
cutset|cutest
cyanamid|adynamic
cyril|lyric
d'art|dart|drat
d'oeuvre|doeuvre|overdue
da|ad
dab|bad
dabber|barbed
dabbler|rabbled|drabble
dabs|bads
dacron|conrad|candor
dad|add
dade|dead
dailies|liaised
daily|lydia
dairies|diaries
dairy|diary
dais|aids|said
daises|asides
dale|deal|lade|lead
dales|leads|deals
dam|mad
dame|made|mead
damon|nomad|monad
damper|ramped
damsel|medals
dan|and
dance|caned
dances|ascend
dander|darned
dane|aden|dean|edna
daniel|nailed|denial
dante|anted
danzig|dazing
dapper|rapped
dapple|lapped
dare|dear|erda|read
dared|adder|dread
darer|drear
dares|dears|reads
darius|radius
darken|ranked
darlene|learned|leander
darling|larding
darn|rand
darned|dander
darner|errand
dart|d'art|drat
darted|traded
darter|tarred|trader|retard
darting|trading
darwin|inward
dash|shad
dashed|shaded
dasher|shared|shader
dashes|shades|sashed
dashing|shading
dateline|entailed
dater|tread|rated|trade
dates|stade|stead|sated
datsun|daunts
daub|baud
daubs|bauds
daunted|undated
daunts|datsun
dave|vade|deva|veda
davies|advise
dawdle|waddle
dawdled|waddled
dawdler|drawled|waddler
dawdles|swaddle|waddles
dawdling|waddling
dawn|wand
daze|adze
dazing|danzig
deacon|canoed
dead|dade
deadlier|derailed
deaf|fade
deal|lade|dale|lead
dealer|leader
dealers|leaders
dealing|leading|aligned
dealings|signaled
deals|leads|dales
dealt|lated|delta
dean|aden|edna|dane
deanna|andean
deans|sedan|andes
dear|erda|read|dare
dearborn|bernardo
dearer|reared|reread|reader
dears|dares|reads
dearth|thread|hatred
death|hated
deaths|hasted
debase|seabed
debater|rebated|berated
debator|aborted
debators|broadest
debrief|briefed|fibered
debunk|bunked
debunker|bunkered
debut|tubed
debuts|busted
decadent|decanted
decal|laced
decals|scaled
decamp|camped
decant|cadent
decanted|decadent
decanter|recanted|cantered
decants|descant
deceiver|received
decennial|celandine
decimal|claimed|declaim
decimals|declaims|midscale
decimate|medicate
decipher|ciphered
declaim|claimed|decimal
declaims|decimals|midscale
declare|cleared|creedal
declines|silenced|licensed
decor|coder|cored|credo
decree|recede
decreed|receded
decrees|recedes|seceder
decrepit|depicter
deduce|deuced
deduces|seduced
deeding|deigned
deer|reed
deers|reeds|seder
default|faulted
defeats|feasted
defer|freed
deferrer|referred
defiant|fainted
defiled|fielded
defiler|fielder
defiling|fielding
definer|refined
deflater|faltered
defocus|focused
deforest|fostered|forested
deform|formed
deforms|serfdom
defray|frayed
defrock|frocked
defrost|frosted
degas|egads
degrader|regarded
deified|edified
deify|edify
deifying|edifying
deigned|deeding
deigns|signed|design|singed
deism|dimes
deity|diety
deja|jade
delano|loaned
deletes|steeled
deletion|entoiled
deli|lied|idle
delia|ideal
delight|lighted
delights|slighted
delimit|limited
delis|sidle|idles|slide
deliver|reviled
delivers|slivered|silvered
della|ladle
delta|lated|dealt
deltas|slated|salted|lasted
delude|dueled|eluded
deluding|indulged
delusion|unsoiled
demanded|maddened
demander|remanded
demark|marked
demean|amende
demeanor|enamored
demerit|merited|mitered
demised|misdeed
demit|timed
demo|dome|mode
demoniac|comedian
demos|modes|domes
demote|emoted
demotion|motioned
den|end
denial|nailed|daniel
denied|indeed
denier|reined|nereid
denim|mined
dennis|sinned
dens|send|ends
dense|needs
denser|resend|sender
density|destiny
dent|tend
dentals|slanted
dented|tended
denting|tending
dentist|distent
denton|tendon
dents|tends
denture|tenured|retuned
denver|vender|nerved
deny|dyne
depart|prated|parted|petard
departed|predated
depicter|decrepit
deplane|paneled
deploy|ployed
deport|redtop|ported
deports|sported
depose|epodes
deposed|seedpod
deposit|posited|topside
deposits|topsides
deprave|pervade
depraved|pervaded
depraves|pervades
depress|pressed
derail|railed|dialer|redial
derailed|deadlier
deranged|gardened
derate|teared
derision|ironside
derives|diverse|revised|deviser
dermal|medlar
descant|decants
descent|scented
desert|rested
deserts|tressed|dessert
deserve|severed
deserver|reserved|reversed
design|deigns|signed|singed
designer|resigned|redesign
desire|reside
desirer|resider
desires|resides
desmond|edmonds
despair|diapers|aspired|praised
despiser|presides|disperse
dessert|tressed|deserts
desserts|stressed
destiny|density
detaches|sacheted
detail|dilate|tailed
detailer|retailed
details|dilates
detainer|retained
detent|netted|tented
deter|treed
detest|tested
detour|routed|toured
deuce|educe
deuced|deduce
deuces|seduce
deus|used|dues|sued
deva|vade|dave|veda
deviates|sedative
deviser|derives|diverse|revised
devisor|visored
devoid|voided
devolve|evolved
devote|vetoed
dew|wed|we'd
dewar|wader
dewily|wieldy|widely
dewiness|wideness
dewing|winged
dewitt|witted
deworm|wormed
dews|weds
dey|dye
dial|laid
dialect|citadel
dialed|laddie
dialer|railed|redial|derail
diana|nadia|naiad
dianne|nadine
diaper|paired|repaid
diapers|aspired|despair|praised
diaries|dairies
diary|dairy
diastole|isolated
diatoms|mastoid
dibs|bids
dice|iced
dicer|cider|cried
didact|addict
diddle|lidded
diddler|riddled
diem|idem|dime
dies|side|ides
diesel|seidel
diet|edit|tide|tied
dieter|tiered|retied
dieting|ignited|editing
diets|sited|edits|tides
diety|deity
digger|rigged
dignity|tidying
dikes|skied
dilate|detail|tailed
dilates|details
dilatory|idolatry|adroitly
dilutes|duelist
dim|mid
dime|diem|idem
dimer|mired
dimes|deism
dimmer|rimmed
dimple|limped
dine|enid
diners|rinsed|snider
dines|snide
dingo|doing
dingy|dying
dinkey|kidney
dipper|ripped
dirac|radic|acrid
direct|credit
directed|credited
director|creditor
directs|credits
dirge|ridge
dirged|girded|ridged
dirges|ridges
disarmer|admirers
discern|rescind|cinders
discount|conduits
discover|divorces
discreet|discrete
discrete|discreet
disease|seaside
dishes|hissed
dishing|shindig
disney|sidney
disowned|downside
dispell|spilled
disperse|presides|despiser
disposer|dropsies
disprove|provides
disserve|dissever
dissever|disserve
distent|dentist
disuse|issued
diva|avid|vida
dive|vied|vide
diver|drive|verdi
divers|drives
diverse|derives|revised|deviser
dives|vised
divorces|discover
dnieper|ripened
do|od
dob|bod
doc|cod
docile|coiled
docker|corked|rocked
dockets|stocked
doctrine|centroid
dod|odd
doe|ode
does|dose
doeuvre|d'oeuvre|overdue
doing|dingo
doings|dosing
dolan|nodal
dole|lode
dolly|lloyd
dolt|told
domains|madison
dome|demo|mode
domes|demos|modes
domingo|dooming
domino|monoid
don|nod
donator|tornado
done|node
doneck|conked
donor|rondo
doodler|drooled
doom|mood
dooming|domingo
dooms|moods
door|odor|rood
doorbell|bordello
doorpost|doorstop
doors|odors
doorstop|doorpost
doper|pedro|roped|pored
dopes|posed
dopier|period
dora|road
doreen|redone
doria|radio
dos|sod
dosage|seadog
dose|does
dosing|doings
dost|dots
dote|toed
dots|dost
dotter|rotted
doubler|boulder
doubter|redoubt|obtrude
dourness|resounds
dover|drove|roved
dovetail|violated
dower|rowed
download|woodland
downside|disowned
downturn|turndown
dowries|rowdies|weirdos
dowry|rowdy|wordy
dowse|sowed
dowser|drowse
doyle|yodel
drabble|rabbled|dabbler
drake|raked
dramas|madras
drat|dart|d'art
draw|ward
drawback|backward
drawed|wadder|edward
drawer|warred|reward|redraw
drawers|rewards
drawled|dawdler|waddler
draws|wards
dray|yard
dread|dared|adder
dreads|sadder
dream|armed
dreamer|rearmed
dreaming|margined|midrange
drear|darer
dresser|redress
drib|bird
drive|verdi|diver
drives|divers
drones|snored
drooled|doodler
dropsies|disposer
drove|dover|roved
drowse|dowser
dryer|ryder
dual|laud|auld
dubber|rubbed
duce|cued
dueled|eluded|delude
dueling|indulge|eluding
duelist|dilutes
duels|dulse
dues|deus|used|sued
duffel|duffle
duffle|duffel
dulse|duels
dummies|mediums
dunlap|upland
duodenal|unloaded
duper|prude
durango|aground
durer|ruder
dust|stud
duster|rudest|rusted
dustpan|upstand
dusty|study
dwindles|swindled
dye|dey
dyed|eddy
dying|dingy
dynamo|monday
dyne|deny
e'er|ere
each|ache
eager|agree|eagre
eaglet|legate|gelate
eagre|eager|agree
ear|era|are|rae
earl|real|lear|rale
earn|near|rena
earned|endear|neared
earner|nearer
earnest|eastern|nearest
earns|snare|saner|nears
ears|sear|sera|ares|eras
earth|heart|hater
earthen|hearten|teheran
earthier|heartier
earthily|heartily
earthly|hartley
earths|hearst|haters|hearts
earthy|thayer|hearty
easel|lease
easer|erase
easing|gaines
east|sate|teas|seat|eats
easter|eaters|teresa|teaser|seater
eastern|earnest|nearest
easting|teasing|seating
eat|tea|ate|eta
eaters|easter|teresa|teaser|seater
eaton|atone
eats|sate|teas|east|seat
eben|been
echidna|chained
echos|chose
eclat|cleat
ecru|cure
eddy|dyed
edema|medea
eden|need
edger|greed
edges|sedge
edible|belied
edict|cited
edified|deified
edify|deify
edifying|deifying
edison|onside
edit|diet|tide|tied
editing|ignited|dieting
editions|sedition
editor|rioted|triode
editors|storied|steroid
edits|sited|diets|tides
edmonds|desmond
edna|aden|dean|dane
educe|deuce
eductor|courted
edward|wadder|drawed
edwin|wined|widen
eel|lee
eery|eyre
egad|aged
egads|degas
egocentric|geocentric
egoist|stogie
egoists|stogies
egos|goes
egret|greet
eh|he
eighth|height
eighths|heights|highest
einstein|nineties
eire|erie
eisner|serine
elaine|aileen
elan|lean|lane|neal
elapse|please|asleep
elapsed|pleased
elapses|pleases
elapsing|pleasing
elastics|alcestis
elastin|saltine|salient|entails
elater|relate
elates|teasel
elating|genital|gelatin|atingle
elation|toenail
elba|abel|bale|able|bela
elbow|below|bowel
elbows|bowels
eldon|olden
elector|electro
electors|selector
electra|treacle
electro|elector
elects|select
elfs|self
elisha|sheila
ellis|lisle
elmer|merle
elmira|mailer
else|lees
elsevier|relieves
eluded|dueled|delude
eluding|dueling|indulge
elution|outline
em|me
emanate|manatee
embryos|moresby
emery|meyer
emil|lime|mile
emily|limey
emir|rime|mire
emirate|meatier
emit|item|mite|time
emits|smite|items|times|mites
emory|moyer
emoted|demote
emphasis|misshape
empire|premie
empires|premise
employer|reemploy
enacts|ascent|stance|secant
enamored|demeanor
encase|seance|seneca
enclave|valence
enclaves|valences
encoder|encored
encored|encoder
encroach|cochrane
end|den
endear|earned|neared
endings|sending
endive|veined|envied
endow|owned
endows|snowed
ends|send|dens
endures|ensured
enemy|yemen
enervate|venerate
enforcer|confrere
engel|engle
engined|needing
englander|greenland
engle|engel
english|shingle
engrave|avenger
engraves|avengers
enid|dine
enigma|imagen
enlarge|gleaner|general
enlarges|generals
enlist|inlets|listen|tinsel|silent
enlisted|tinseled|listened
enlistee|selenite
enlister|reenlist|listener
enlists|listens|silents
enoch|cohen
enrapt|parent|entrap
enrico|recoin|coiner
ensigns|sensing
ensnared|andersen
ensnares|nearness
ensured|endures
entail|tineal
entailed|dateline
entails|saltine|salient|elastin
enterer|reenter
enters|resent|tenser|ernest|nester
entirety|eternity
entoiled|deletion
entrail|ratline|latrine|reliant|retinal
entrails|latrines
entrap|parent|enrapt
entraps|parents
entries|steiner
envied|veined|endive
envious|veinous
enwrap|pawner
eon|one
eons|ones|nose
epodes|depose
epsom|poems|mopes
epson|opens
equals|squeal
equators|quaestor
equip|pique
er|re
era|are|ear|rae
eras|sear|ears|sera|ares
erase|easer
erato|orate
erbium|imbrue
erda|dear|read|dare
ere|e'er
ergo|gore|ogre|goer
eric|rice
erich|reich
ericsson|necrosis
erie|eire
ernest|enters|resent|tenser|nester
ernie|irene
ernst|stern|rents
erotism|mortise
errand|darner
errant|ranter
erratum|maturer
erupted|reputed
erupting|reputing
erupts|purest
ervin|riven
escallop|collapse
escheat|teaches
escort|corset|sector
escorted|sectored|corseted
escorts|sectors|corsets
escot|coset
escrow|cowers
esker|reeks
esmark|masker|makers
esposito|isotopes
essen|sense
ester|terse|steer|reset|trees
esther|threes|ethers|hester
estimate|meatiest
estop|poets
estrange|reagents|sergeant|grantees
estray|stayer
estrus|surest|russet
eta|tea|ate|eat
etch|tech
eternity|entirety
eth|the
ethan|neath
ethel|lethe
ether|there|three
ethers|threes|hester|esther
ethics|itches
ethos|those
etruscan|recusant|centaurs
euridyce|eurydice
eurydice|euridyce
eva|ave
evaders|adverse
evans|vanes
evelyn|evenly
even|neve
evener|veneer
evenly|evelyn
evens|seven
events|steven
ever|veer
evert|revet
every|veery
evict|civet
evictors|vortices
evil|vile|veil|levi|live
eviler|revile|relive
evilly|lively|vilely
evilness|vileness
evils|lives|veils|levis
evince|venice
evocator|overcoat
evolved|devolve
ewe|wee
ewer|we're|were
exacter|excreta
exalt|latex
except|expect
excepted|expected
excides|excised
excised|excides
excitation|intoxicate
exclaims|climaxes
excreta|exacter
exerts|exsert
exist|exits
exits|exist
expect|except
expected|excepted
exploder|explored
explored|exploder
exsert|exerts
extra|taxer
eyelids|seedily
eyra|year|aery
eyre|eery
ezra|raze
facture|furcate
factures|furcates
fad|fda
fade|deaf
fader|fared
faery|freya
failed|afield
fainted|defiant
faker|freak
falcon|flacon
false|fleas|leafs
falser|flares
faltered|deflater
fare|fear
fared|fader
fares|fears|safer
farmed|framed
farmer|framer
farmers|framers
farming|framing
faro|afro|fora
fasten|stefan
faster|strafe|afters
faulted|default
faults|flatus
fbi|fib
fda|fad
fear|fare
fears|fares|safer
feasted|defeats
feasts|safest
feeder|reefed
feeding|feigned
feet|fete
feigned|feeding
feigner|freeing
feints|infest|finest
felinity|finitely
felones|oneself
felsite|lefties
felt|left
felts|lefts
feral|flare
ferine|refine
ferry|fryer
fester|freest
fete|feet
fetor|forte
feuds|fused
fib|fbi
fiber|fibre|brief
fibered|briefed|debrief
fibers|briefs
fibre|fiber|brief
fiche|chief
fief|fife
field|filed
fielded|defiled
fielder|defiler
fielding|defiling
fiend|fined
fiendish|finished
fierce|recife
fife|fief
fighter|freight
fighters|freights
filar|frail|flair
file|life
filed|field
files|flies
filets|stifle|itself
filler|refill
fillers|refills
finagle|leafing
finder|friend
finders|friends
fined|fiend
finely|finley
finer|infer
finest|infest|feints
finished|fiendish
finisher|refinish
finitely|felinity
finites|nifties
finley|finely
fire|rife
fired|fried
firer|frier
fires|fries|serif
first|rifts
fissure|fussier
flacon|falcon
flair|frail|filar
flanker|frankel
flare|feral
flared|alfred
flares|falser
flatcar|fractal
flatiron|inflator
flatus|faults
flea|leaf
fleas|false|leafs
flemish|himself
flies|files
flirting|trifling
flit|lift
flits|lifts
flue|fuel
fluent|unfelt
flushing|lungfish
foal|olaf|loaf
foals|loafs
foci|coif
focused|defocus
focuser|refocus
foil|lifo
for|fro
fora|afro|faro
forces|fresco
forensic|conifers
forest|fortes|foster|softer
forested|deforest|fostered
forester|fosterer|reforest
forests|fosters
form|from
formed|deform
former|reform
forte|fetor
fortes|foster|forest|softer
forth|froth
forts|frost
foster|fortes|forest|softer
fostered|deforest|forested
fosterer|forester|reforest
fosters|forests
fractal|flatcar
frail|flair|filar
framed|farmed
framer|farmer
framers|farmers
framing|farming
frankel|flanker
frantic|infract|infarct
frayed|defray
freak|faker
free|reef
freebie|beefier
freed|defer
freeing|feigner
freer|refer
frees|reefs
freest|fester
freight|fighter
freights|fighters
fresco|forces
fresher|refresh
fretful|truffle
frey|frye
freya|faery
friary|rarify
fried|fired
friend|finder
friends|finders
frier|firer
fries|fires|serif
frit|rift
fro|for
frocked|defrock
from|form
frost|forts
frosted|defrost
froth|forth
frye|frey
fryer|ferry
fuel|flue
fueler|refuel
fulcra|carful
furcate|facture
furcates|factures
furs|surf
fused|feuds
fussier|fissure
gab|bag
gabbler|grabble
gable|bagel
gabler|garble
gables|bagels
gadder|graded
gadget|tagged
gagster|stagger
gagsters|staggers
gail|gila
gain|gina
gainer|regina|regain
gaines|easing
gal|lag
gala|alga
galen|glean|angel|angle|lange
galena|angela
galenite|gelatine
gallery|allergy|largely|regally
gantries|angriest|granites
gaol|goal|olga
gape|page
gaped|paged
gapes|pages
gaps|gasp
garbed|badger|barged
garble|gabler
gardened|deranged
gardener|garnered
gardner|grander
gargle|lagger
garner|ranger
garnered|gardener
garners|rangers
garret|grater|garter
garrets|garters
garter|garret|grater
garters|garrets
gary|gray
gas|sag
gases|sages
gasp|gaps
gast|tags|stag
gat|tag
gates|stage
gateway|getaway
gateways|getaways
gator|groat|argot
gave|vega
gay|agy
gazer|graze
gazers|grazes
geared|agreed
gel|leg
gelate|legate|eaglet
gelatin|genital|elating|atingle
gelatine|galenite
gelding|niggled
geldings|sledging
gelid|glide
gem|meg
general|gleaner|enlarge
generals|enlarges
geneva|avenge
genial|linage
genital|gelatin|elating|atingle
genitals|stealing
genoa|agone
genre|green
genres|greens
gentian|anteing|antigen
gentiles|steeling
geocentric|egocentric
gerald|glared
gerard|regard|grader
gerber|berger
german|manger
germinal|malinger
gerund|nudger
gestapo|postage
getaway|gateway
getaways|gateways
ghouls|slough
giants|sating
gib|big
gibbons|sobbing
gila|gail
gilded|glided
gilding|gliding
giller|grille
gina|gain
gingered|renigged
gingery|greying
gingko|ginkgo
ginkgo|gingko
ginmill|milling
gins|sing|sign
gird|grid
girded|dirged|ridged
girds|grids
giro|igor
girt|grit|trig
glanced|clanged
glancing|clanging
glans|slang
glare|large|lager|alger|regal
glared|gerald
glares|lagers
glary|gyral
glean|angel|angle|lange|galen
gleaner|enlarge|general
gleans|angels|angles
gleed|ledge
glees|leges
glibness|blessing
glide|gelid
glided|gilded
gliding|gilding
glinted|tingled
glinting|tingling
glisten|singlet|tingles
glue|luge
gluer|luger|gruel
glues|gules
gluily|uglily
gnash|hangs
gnaw|wang
gnawer|wagner
gnaws|swang
gnomonic|oncoming
gnostic|costing
goa|ago
goal|gaol|olga
goals|lagos
goat|toga
gob|bog
goer|gore|ogre|ergo
goers|gorse|gores
goes|egos
goldstein|goldstine
goldstine|goldstein
goleta|legato
goner|goren|negro
goober|booger
goop|pogo
gop|gpo
gore|ogre|ergo|goer
goren|goner|negro
gores|gorse|goers
gorse|goers|gores
gorton|groton
gosh|hogs
got|tog
goucher|cougher
gown|wong
gpo|gop
grabble|gabbler
graded|gadder
grader|regard|gerard
graders|regards
gradient|treading
grading|niggard
grandam|grandma
grander|gardner
grandma|grandam
grange|nagger
granites|angriest|gantries
grantee|negater|reagent
grantees|reagents|estrange|sergeant
grate|great|greta
grater|garret|garter
grates|greats|stager
gravel|verlag
gray|gary
graze|gazer
grazes|gazers
great|greta|grate
greats|grates|stager
greed|edger
green|genre
greene|renege
greened|reneged
greening|reneging
greenland|englander
greens|genres
greet|egret
greeter|regreet
greta|great|grate
grey|gyre
greying|gingery
grid|gird
grids|girds
grille|giller
grimaces|scrimage
grinned|rending
grip|prig
grips|sprig
grist|grits
grit|girt|trig
grits|grist
groan|argon|organ
groans|organs|sarong
groat|gator|argot
groton|gorton
grounded|underdog
grounder|reground
grouper|regroup
groupie|pirogue
grower|regrow
grown|wrong
grub|burg
grudge|rugged
gruel|luger|gluer
grunts|strung
guerdon|undergo
guiana|iguana
guides|guised
guised|guides
gul|lug
gules|glues
gullible|bluegill
gum|mug
gums|mugs|smug
gurgle|lugger
gurgles|slugger
gush|hugs
gushing|huggins
gust|tugs|guts
gustave|vaguest
gusty|gutsy
gut|tug
guts|gust|tugs
gutsy|gusty
gyral|glary
gyre|grey
ha|ah
haddocks|shaddock
hade|head
hades|heads|shade
hailed|halide
hairs|shari
hale|heal
haley|healy
halide|hailed
halls|shall
halma|hamal
halos|shoal
halsey|ashley|shaley
halt|lath
halter|lather
haltered|lathered
halting|lathing
halts|shalt|stahl
hamal|halma
hamlet|thelma
hammers|shammer
hampton|phantom
hams|sham|mash
hamster|amherst
handel|handle
hander|harden
handfuls|handsful
handle|handel
handouts|thousand
handsful|handfuls
handy|haydn
haney|hyena
hangover|overhang
hangs|gnash
hank|kahn|khan
hanker|harken
hansom|monash
harbored|abhorred
harborer|abhorrer
harden|hander
hardened|adherend
hardest|threads|trashed
hardier|harried
hardy|hydra
hare|hear|rhea|hera
hares|hears|shear|share|asher
harken|hanker
harks|shark
harms|marsh
harpers|sharper
harps|sharp
harried|hardier
hartley|earthly
has|ash
hasn't|shan't
hast|hats
haste|heats|hates
hasted|deaths
hasten|athens
hastiest|atheists
hate|thea|heat
hated|death
hater|earth|heart
haters|hearst|earths|hearts
hates|heats|haste
hatred|thread|dearth
hats|hast
hatter|threat
haul|hula
haunter|unearth
havens|shaven
havers|shaver
haves|shave
haw|wah
hay|yah
haydn|handy
haynes|hyenas
hays|shay|ashy
he|eh
he'll|hell
head|hade
header|adhere
headers|adheres|sheared
headpin|pinhead
heads|shade|hades
heal|hale
heals|shale|leash
healy|haley
heaps|phase|shape
hear|hare|rhea|hera
hearers|shearer
hears|shear|hares|share|asher
hearst|haters|earths|hearts
heart|earth|hater
hearten|earthen|teheran
heartier|earthier
heartily|earthily
hearts|hearst|haters|earths
hearty|earthy|thayer
heat|hate|thea
heaters|theresa
heaths|sheath
heats|hates|haste
heaves|sheave
hectare|cheater|teacher
hectares|teachers|cheaters
height|eighth
heights|highest|eighths
heir|hire
heirless|relishes
heirs|hires|shire
heisting|nighties
heists|shiest|thesis
hell|he'll
hellenic|chenille
hells|she'll|shell
hems|mesh
henri|rhine
heptagon|pathogen
hera|hear|hare|rhea
herds|shred|sherd
herein|inhere
hernial|inhaler
hero|hoer
heron|honer
hester|threes|ethers|esther
hetman|anthem
hewer|where
hewn|when
hider|hired
hides|shied
higgins|sighing
highest|heights|eighths
hight|thigh
hikers|shriek|shrike
hikes|sheik
hills|shill
himself|flemish
hines|shine
hinge|neigh
hint|thin
hints|thins
hip|phi
hips|ship
hire|heir
hired|hider
hires|shire|heirs
hissed|dishes
hisself|selfish
hisser|shires
ho|oh
hoar|hora
hoard|rhoda
hock|koch
hocker|choker
hocks|shock
hoedown|woodhen
hoer|hero
hoes|hose|shoe
hogs|gosh
hoister|shortie
holdup|uphold
holdups|upholds
holiest|hostile
holst|sloth
holstein|hotlines
holster|hostler
homage|ohmage
honer|heron
hones|shone
hooks|shook
hops|shop|posh
hora|hoar
horde|rhode
hordes|rhodes|shored
horses|shores
horus|hours
hose|hoes|shoe
hosed|shoed
hoses|shoes
hostel|hotels
hostile|holiest
hostler|holster
hot|tho
hotelman|methanol
hotels|hostel
hotline|neolith
hotlines|holstein
hounds|hudson|unshod
hours|horus
houseboat|boathouse
hovels|shovel
hovers|shrove|shover
how|who
however|whoever
hows|show
howsoever|whosoever
howsomever|whomsoever|howsomever
hubs|bush
huddler|hurdled
hudson|hounds|unshod
hug|ugh
huggins|gushing
hugs|gush
hula|haul
humidor|rhodium
hums|mush
hunk|kuhn
huns|shun
hunters|shunter
hunts|shunt
huntsman|manhunts
hurdle|hurled
hurdled|huddler
hurled|hurdle
hurst|hurts
hurt|thru|ruth
hurtle|luther
hurtles|hustler
hurts|hurst
hustle|sleuth
hustler|hurtles
hustlers|ruthless
hustling|sunlight
huts|tush|shut|thus
hydra|hardy
hyena|haney
hyenas|haynes
hyman|mynah
i'd|id
i'll|ill
i've|vie
iced|dice
iceman|anemic|cinema
iciest|cities
iciness|incises
icon|coin
icons|coins|scion|sonic
id|i'd
idea|aide
ideal|delia
ideals|sailed|ladies
ideas|aside|sadie|aides
idem|diem|dime
identic|incited
ides|dies|side
idle|deli|lied
idlers|slider
idles|sidle|slide|delis
idlest|listed
idly|idyl
idolater|tailored
idolatry|dilatory|adroitly
idols|solid
idyl|idly
ignite|tieing
ignited|editing|dieting
ignitor|rioting
ignore|region
ignores|regions
igor|giro
iguana|guiana
ikon|oink
iliac|cilia
ill|i'll
ills|sill
illy|lily
ilmenite|timeline
imagen|enigma
imam|maim
imbed|bedim
imbrue|erbium
imbrute|terbium
immersed|simmered
immures|rummies
impart|armpit
impeding|impinged
impels|simple
impetus|imputes
impinged|impeding
importunate|permutation
imposer|promise
impress|simpers
impressible|permissible
impression|permission
impressive|permissive
imprest|permits
imprints|misprint
imps|simp
impure|umpire
impute|uptime
imputes|impetus
inane|annie
inanes|sienna|insane
inapt|paint
inbred|binder
inbuilt|builtin
inca|cain
incase|casein
incenses|niceness
incept|pectin
inch|chin
inches|niches
incised|indices
incises|iciness
incited|identic
include|nuclide
incur|runic
indeed|denied
indent|intend|tinned
indented|intended
indenter|interned|intender
indents|intends
indicate|actinide
indices|incised
indicter|indirect
indies|inside
indirect|indicter
indorse|rosined
indulge|dueling|eluding
indulged|deluding
inert|inter
inertance|nectarine
infarct|frantic|infract
infer|finer
infest|finest|feints
infidel|infield
infield|infidel
inflator|flatiron
infract|frantic|infarct
ingest|signet
ingram|arming|margin
ingress|signers|resigns|singers
ingrowth|throwing
inhaler|hernial
inhere|herein
ink|kin
inkle|klein|kline|liken
inks|skin|sink
inlets|listen|tinsel|silent|enlist
innings|sinning
inroad|ordain
inroads|ordains
ins|sin
insane|sienna|inanes
insert|sinter
inserted|resident
inset|tines|stein
inside|indies
insisted|tidiness
insole|lesion
instance|ancients
insult|sunlit
insulted|unlisted
insure|inures|ursine
insures|sunrise
intake|aitken
integer|treeing
intend|tinned|indent
intended|indented
intender|interned|indenter
intends|indents
inter|inert
interim|termini
intern|tinner
interned|intender|indenter
interred|trendier
into|toni|oint
intones|tension
intoxicate|excitation
intreat|nitrate|nattier
intro|nitro
intrude|untried
inured|ruined
inures|insure|ursine
invader|ravined
inverts|striven
inward|darwin
ira|air
irate|artie
irately|reality|tearily
irene|ernie
irks|risk
irksome|smokier
irma|mira
iron|orin
ironies|noisier
irons|rosin
ironside|derision
irrupts|stirrup
irs|sir
is|si
isabella|sailable
islam|mails
island|landis
isle|lies|lise
islet|tiles|stile
islets|stiles
isn't|tins
isocline|silicone
isolated|diastole
isolde|oldies|soiled
isotopes|esposito
isotropy|porosity
israel|serial|resail|sailer
issue|susie
issued|disuse
it|ti
italy|laity
itch|chit
itches|ethics
item|emit|mite|time
items|smite|emits|times|mites
iterates|treaties|treatise
its|sit
itself|stifle|filets
ivan|vain
iverson|version
jade|deja
jane|jean
janos|jason|jonas
jar|raj
jason|janos|jonas
jaunt|junta
jean|jane
jeers|jeres
jeres|jeers
jest|jets
jets|jest
joes|jose
johannes|johansen
johansen|johannes
joiner|rejoin
jonas|jason|janos
jose|joes
junta|jaunt
just|juts
juts|just
kabul|baulk
kae|kea
kahn|hank|khan
kant|tank
karl|lark
karp|park
kas|ask
kate|teak|take
kay|yak
kayo|okay
kea|kae
keats|takes|stake|steak|skate
keel|leek
keels|sleek
keen|knee
keening|kneeing
keep|peek
keeps|peeks
kestrel|skelter
khan|kahn|hank
kibe|bike
kidney|dinkey
kills|skill
kiln|link
kilo|loki
kin|ink
kindle|linked
kindles|slinked
kinfolks|kinsfolk
kinsfolk|kinfolks
kinship|pinkish
kippers|skipper
kips|skip
kiss|skis
kisser|skiers
kitchen|thicken
kitchens|thickens
kite|tike
kits|skit
klan|lank
klein|kline|inkle|liken
kline|klein|inkle|liken
knee|keen
kneeing|keening
knits|stink
knitter|trinket
knot|tonk
koch|hock
koran|akron
kramer|marker|remark
kuhn|hunk
kurt|turk
label|bella
labile|liable
labor|lobar
labs|slab
lace|alec
laced|decal
lacer|clare|clear
laces|scale
lack|calk
lackey|ackley
lacks|slack
laconic|conical
lactose|locates
ladder|larded
ladders|saddler
laddie|dialed
lade|deal|dale|lead
laden|alden
ladies|sailed|ideals
ladle|della
lag|gal
lager|large|alger|regal|glare
lagers|glares
lagger|gargle
lagos|goals
laid|dial
lain|nail
lair|liar|lira|rail
lairs|rails|liars|liras
laity|italy
lam|mal
lama|alma
lamar|alarm
lamb|balm
laming|malign
lamp|palm
lamps|psalm|plasm|palms
lancaster|ancestral
lance|clean
lanced|candle
lances|cleans
lancet|cantle
landis|island
lane|lean|elan|neal
lanes|leans
lange|glean|angel|angle|galen
lank|klan
laos|also
laotian|alation
lap|alp|pal
lapis|pails
laplace|capella
lapped|dapple
lapse|peals|leaps|sepal|pleas|pales
lapsed|pedals|pleads
lapsing|sapling
larded|ladder
larding|darling
laredo|ordeal|loader|reload
lares|laser|reals
large|lager|alger|regal|glare
largely|allergy|gallery|regally
lariat|atrial|altair
lark|karl
lascar|scalar|sacral|rascal
lase|sale|seal
laser|lares|reals
last|salt|slat
lasted|slated|deltas|salted
lasting|slating|salting
lasts|salts|slats
latches|satchel
late|teal|tale
lated|dealt|delta
latent|talent
latents|talents
later|alter|alert
laterite|literate
latex|exalt
lath|halt
lather|halter
lathered|haltered
lathing|halting
latrine|entrail|ratline|reliant|retinal
latrines|entrails
latrobe|bloater|alberto
latter|rattle
lattice|tactile
latus|tulsa|sault|talus
laud|dual|auld
laura|aural
laurel|allure
lauren|neural|unreal
laurence|cerulean
laurent|neutral|renault
lava|alva
lave|vale|veal
lavender|vreeland
laver|ravel|velar
law|awl
laws|slaw
laze|zeal
lea|ale
lead|deal|lade|dale
leaden|leaned
leader|dealer
leaders|dealers
leading|dealing|aligned
leads|dales|deals
leaf|flea
leafing|finagle
leafs|fleas|false
lean|elan|lane|neal
leander|learned|darlene
leaned|leaden
leans|lanes
leap|peal|plea|pale
leaper|repeal
leaps|peals|sepal|pleas|lapse|pales
leapt|pleat|plate|petal
lear|real|earl|rale
learn|renal|arlen
learned|darlene|leander
learner|relearn
learners|relearns
lease|easel
leased|sealed
leash|shale|heals
leasing|sealing
least|steal|teals|tales|stale|slate
leaver|reveal
lebensraum|mensurable
lectures|cruelest
ledge|gleed
ledger|redleg
ledges|sledge
lee|eel
leek|keel
leer|reel
leered|reeled
leers|reels
lees|else
left|felt
lefties|felsite
lefts|felts
leg|gel
legate|eaglet|gelate
legato|goleta
leges|glees
legions|lingoes
lei|lie
lemon|menlo|monel|melon
lenders|slender
lenin|linen
lenses|lessen
leo|ole
leon|noel|lone
leona|alone
leopard|paroled
leper|repel|perle
lepers|repels
lesion|insole
lesions|lioness
lessen|lenses
lessened|needless
lessons|sonless
lessor|losers
lest|lets
lethe|ethel
lets|lest
letters|settler|trestle
letup|tuple
levees|sleeve
lever|revel
levered|reveled
levers|revels
levi|vile|evil|veil|live
levied|veiled
levin|liven
levis|lives|evils|veils
lewd|weld
lewis|wiles
ley|lye
leyden|needly
liable|labile
liaised|dailies
liar|lira|rail|lair
liars|rails|lairs|liras
lice|ceil
license|silence
licensed|silenced|declines
licenser|silencer|reclines
licenses|silences
licks|slick
lidded|diddle
lids|slid
lie|lei
lied|deli|idle
lien|nile|neil|line
liens|lines
lier|rile|lire
lies|lise|isle
life|file
lifo|foil
lift|flit
lifts|flits
lighted|delight
lights|slight
lignin|lining
liken|klein|kline|inkle
lily|illy
lima|mila|mail|mali
limbo|mobil
lime|emil|mile
limes|slime|smile|miles
limey|emily
limitate|militate
limited|delimit
limped|dimple
linage|genial
lindsey|snidely
line|nile|neil|lien
linear|nailer
lineman|melanin
linen|lenin
lines|liens
lineup|unpile|lupine
lingers|slinger
lingoes|legions
lining|lignin
link|kiln
linked|kindle
lion|loin|olin
lionel|o'neill
lioness|lesions
liquate|tequila
lira|liar|rail|lair
liras|rails|lairs|liars
lire|rile|lier
lisa|ails|sial|sail
lise|lies|isle
lisle|ellis
lisper|perils|pliers
lisping|pilings
listed|idlest
listen|inlets|tinsel|silent|enlist
listened|tinseled|enlisted
listener|reenlist|enlister
listens|enlists|silents
lit|til
liter|tiler
literate|laterite
litter|tilter
live|vile|evil|veil|levi
lively|evilly|vilely
liven|levin
liver|viler|livre
livers|sliver|silver
livery|verily
lives|evils|veils|levis
livre|viler|liver
lizards|szilard
lloyd|dolly
loader|laredo|ordeal|reload
loaders|reloads|ordeals
loaf|olaf|foal
loafs|foals
loaned|delano
loans|sloan|salon
loath|altho
lobar|labor
lobe|bole|loeb
lobo|bolo
lobster|bolster
locality|coitally
locates|lactose
loci|clio|coil
loco|cool
lode|dole
lodge|ogled
loeb|lobe|bole
loess|soles|loses
loftier|trefoil
loin|lion|olin
lois|soil|oils|silo
loki|kilo
lome|mole
lone|noel|leon
loner|loren
longue|lounge
lookout|outlook
lookouts|outlooks
loon|nolo
loosing|soloing
lopper|propel
loppy|polyp
lops|slop
lore|role
loren|loner
lorinda|ordinal
lose|sole|sloe
loser|roles
losers|lessor
loses|soles|loess
lost|lots|slot
lotions|soliton
lots|lost|slot
lottie|toilet
loudest|tousled
lounge|longue
louse|seoul
loused|souled
louver|velour|louvre
louvre|louver|velour
low|owl
lowers|slower
lowest|towels
lows|slow|owls
loyal|alloy
lubber|rubble|burble
lube|blue
lucas|claus
lucre|cruel|ulcer
lug|gul
luge|glue
luger|gluer|gruel
lugger|gurgle
lumber|rumble
lumbers|rumbles|slumber
lump|plum
lumped|plumed
lumpen|plenum
lumper|rumple
lumpier|plumier
lumping|pluming
lumps|slump|plums
lunar|ulnar
lunary|uranyl
lunate|tulane
lundberg|berglund
lungfish|flushing
lungs|slung
lupine|unpile|lineup
lura|raul
lurch|churl
lure|rule
lured|ruled
lurer|ruler
lures|rules
luther|hurtle
lydia|daily
lye|ley
lyings|singly
lyle|yell
lyman|manly
lyon|only
lyons|sonly
lyra|aryl
lyre|rely
lyric|cyril
ma|am
mac|cam
mace|acme|came
macho|mocha
macro|marco|armco
mad|dam
maddened|demanded
made|mead|dame
madison|domains
madras|dramas
madsen|amends
magenta|magnate
magnate|magenta
magneto|megaton|montage
maid|amid
maiden|median
maidens|sideman
maids|midas
maier|ramie|aimer|marie
mail|lima|mila|mali
mailed|medial
mailer|elmira
mailers|realism
mails|islam
maim|imam
makers|esmark|masker
mal|lam
mali|lima|mila|mail
malign|laming
maligned|medaling
malinger|germinal
malls|small
manacle|alcmena
manatee|emanate
mane|name|amen|mean
maned|amend|named
manes|means|names|manse
mangel|mangle
manger|german
mangier|reaming
mangle|mangel
mango|among
manhunts|huntsman
maniac|caiman
manila|animal
manlier|mineral
manliest|ailments
manly|lyman
manor|moran|roman|norma
manors|ransom
manse|means|names|manes
mantis|matins
manual|alumna
manured|unarmed
manures|surname
mao|moa
maori|mario
map|amp|pam
maple|ample
maples|sample
mapper|pamper
maps|amps
mar|arm|ram
marbled|rambled
marbler|rambler
marbles|rambles
marbling|rambling
marc|cram
marcel|calmer
march|charm
marched|charmed
marcher|charmer
marco|armco|macro
mare|ream
mares|maser|smear|reams
margin|ingram|arming
marginal|alarming
margined|dreaming|midrange
marianne|armenian
marie|maier|ramie|aimer
marina|airman
marine|airmen|remain
marino|marion
mario|maori
marion|marino
marital|martial
marked|demark
marker|kramer|remark
markers|remarks
maroon|romano
married|admirer
marsh|harms
marsha|ashram
marshes|mashers|smasher
mart|tram
martial|marital
marts|smart
mary|myra|army
maser|mares|smear|reams
maseru|amuser
mash|hams|sham
mashed|shamed
mashers|marshes|smasher
mashes|shames
mashing|shaming
mashings|smashing
masker|esmark|makers
mason|moans
masons|samson
mast|astm|mats
mastoid|diatoms
mat|tam
matcher|rematch
mate|tame|team|meat
mated|tamed
mater|tamer
materiel|realtime
maternal|alterman
mates|steam|meats|teams
matey|meaty
mating|taming
matins|mantis
matrons|transom
mats|mast|astm
matters|smatter
maturer|erratum
maul|alum
mauls|alums
mawr|warm
may|amy|yam
mayor|moray
mba|bam
me|em
mead|made|dame
mean|name|amen|mane
meander|amender|renamed
meaner|rename
means|names|manes|manse
meat|tame|mate|team
meatier|emirate
meatiest|estimate
meats|steam|mates|teams
meaty|matey
medaling|maligned
medals|damsel
meddle|melded
medea|edema
media|amide|aimed
medial|mailed
median|maiden
medicate|decimate
mediums|dummies
medlar|dermal
medusa|amused
meet|teem|mete
meeting|teeming
meets|teems|metes
meg|gem
megaton|montage|magneto
megatons|montages
melanin|lineman
melded|meddle
melding|mingled
melissa|aimless
melon|menlo|monel|lemon
melts|smelt
menlo|monel|melon|lemon
mensurable|lebensraum
merest|meters
merit|miter|mitre|timer|remit
merited|mitered|demerit
merits|smiter|timers|mister
merle|elmer
mervin|vermin
mesa|ames|same|seam
mescal|camels
mesh|hems
meson|omens
mete|meet|teem
meteor|remote
meters|merest
metes|meets|teems
methanol|hotelman
mets|stem
meyer|emery
mi|i'm
microns|crimson
mid|dim
midas|maids
midrange|margined|dreaming
midscale|decimals|declaims
midterm|trimmed
mien|mine
miens|mines
migrants|smarting
mila|lima|mail|mali
mildness|mindless
mile|emil|lime
miles|slime|smile|limes
militate|limitate
milling|ginmill
minaret|raiment
minder|remind
mindless|mildness
mine|mien
mined|denim
mineral|manlier
mines|miens
mingled|melding
minks|minsk
minos|simon
minot|timon
minsk|minks
mintage|teaming
minuet|minute
minute|minuet
minutely|untimely
mira|irma
miracle|claimer|reclaim
miracles|reclaims
mire|rime|emir
mired|dimer
mires|miser
misdeal|mislead
misdeed|demised
miser|mires
mislead|misdeal
misled|smiled|slimed
misprint|imprints
misread|admires|sidearm
miss|sims
misshape|emphasis
missile|similes
mister|smiter|merits|timers
misting|smiting
mit|tim
mite|item|emit|time
miter|mitre|timer|remit|merit
mitered|merited|demerit
mites|smite|emits|items|times
mitre|miter|timer|remit|merit
moa|mao
moan|oman|mona
moans|mason
moat|atom
mobil|limbo
mocha|macho
mocks|smock
mode|demo|dome
modeler|remodel
models|seldom
modes|demos|domes
moen|omen
moines|monies
mole|lome
moline|oilmen
mona|oman|moan
monad|nomad|damon
monadic|nomadic
monash|hansom
monday|dynamo
monel|menlo|melon|lemon
monger|morgen
monica|camino
monies|moines
mono|moon
monoid|domino
monotreme|metronome
monotreme|metronome
montage|megaton|magneto
montages|megatons
mood|doom
moods|dooms
moon|mono
moor|room
moore|romeo
moored|roomed
moors|rooms
mope|poem|pome
mopes|poems|epsom
moran|manor|roman|norma
moray|mayor
more|rome
mores|moser|morse
moresby|embryos
morgen|monger
morn|norm
moronic|omicron
morse|moser|mores
mortise|erotism
moser|morse|mores
most|toms|mots
mot|tom
mote|tome
motet|totem
motioned|demotion
mots|toms|most
moyer|emory
mug|gum
muggers|smugger
mugs|gums|smug
mundane|unnamed
muscly|clumsy
muser|serum|remus
mush|hums
muss|sums
mussier|surmise
muster|sumter
mutagen|augment
mutilate|ultimate
mutual|umlaut
mynah|hyman
myra|mary|army
na|an
nab|ban
nadia|naiad|diana
nadine|dianne
nagger|grange
nagy|yang
naiad|nadia|diana
nail|lain
nailed|denial|daniel
nailer|linear
nails|snail|slain
naiver|ravine
name|amen|mane|mean
nameable|amenable
named|amend|maned
namer|reman
names|means|manes|manse
nan|ann
nana|anna
nanette|annette
naomi|amino
nap|pan
nape|neap|pane
napes|panes|aspen
naples|planes|panels
napped|append
naps|pans|span|snap
nark|rank
nary|yarn|ryan
nasa|sana
nastily|saintly
nasty|tansy
nat|tan|ant
nate|neat|ante
nation|anoint
nattier|nitrate|intreat
natures|saunter
nave|vane
navel|venal
nay|any
neal|lean|elan|lane
neap|pane|nape
near|rena|earn
nearby|barney
neared|earned|endear
nearer|earner
nearest|eastern|earnest
nearness|ensnares
nears|earns|snare|saner
neat|nate|ante
neath|ethan
nebula|unable
necrosis|ericsson
necrotic|concerti
nectar|trance|canter|cretan|recant
nectarine|inertance
need|eden
needing|engined
needless|lessened
needly|leyden
needs|dense
negater|reagent|grantee
negation|antigone
negro|goner|goren
neigh|hinge
neil|nile|lien|line
neither|therein
nemesis|siemens
neolith|hotline
neon|none
nepal|plane|panel|penal
nerd|rend
nereid|reined|denier
nerve|verne|never
nerved|vender|denver
nerves|severn
nervier|vernier
nest|sent|tens|nets
nested|tensed
nester|enters|resent|tenser|ernest
nesting|tensing
nestler|relents
nestles|netless
net|ten
netless|nestles
nets|sent|tens|nest
netted|detent|tented
netter|tenter
netting|tenting
neural|unreal|lauren
neurosis|resinous
neuter|tenure
neutral|laurent|renault
neve|even
never|nerve|verne
newer|renew
newish|whines
news|sewn
newsier|wieners
newt|went
nib|bin
nibs|bins
niceness|incenses
niche|chine
niches|inches
nifties|finites
niger|renig|reign
niggard|grading
niggled|gelding
night|thing
nighties|heisting
nights|things
nile|neil|lien|line
nineties|einstein
nip|pin
nips|snip|pins|spin
nit|tin
nitrate|nattier|intreat
nitrates|transite
nitro|intro
no|on
nod|don
nodal|dolan
node|done
noel|leon|lone
noisier|ironies
nolo|loon
nomad|damon|monad
nomadic|monadic
none|neon
nooks|snook
nope|peon|open
nor|ron
nora|roan
norm|morn
norma|manor|moran|roman
nose|eons|ones
nosier|senior
nosy|sony
not|ton
note|tone
noted|toned
noter|toner|tenor|notre
notices|section
noting|toning
notre|noter|toner|tenor
nova|avon
now|won|own
nowhere|whereon
nows|sown|snow|owns
nu|un
nub|bun
nuclear|unclear
nuclide|include
nudger|gerund
numberer|renumber
nurse|runes
nursed|sunder
nurser|reruns
nut|tun
nutate|attune
nuts|stun
nyquist|squinty
o'er|ore|roe
o'neill|lionel
oafs|sofa
oaks|soak
oared|adore
oars|sora|soar|rosa
oat|tao
oaths|shoat
oats|taos
obliger|broglie
observe|obverse|verbose
obsess|bosses
obtainer|baritone
obtains|bastion
obtrude|redoubt|doubter
obverse|observe|verbose
occurs|succor|crocus
ocean|canoe
oceans|canoes
ochre|chore
octals|costal
octave|vocate|avocet
octillion|cotillion
od|do
odd|dod
ode|doe
odor|door|rood
odors|doors
offcast|castoff
offset|setoff
ogled|lodge
ogre|gore|ergo|goer
oh|ho
ohmage|homage
oiled|oldie
oilmen|moline
oils|soil|lois|silo
oink|ikon
oint|into|toni
okay|kayo
olaf|foal|loaf
olav|oval
olden|eldon
oldest|stoled
oldie|oiled
oldies|isolde|soiled
ole|leo
olga|gaol|goal
olin|loin|lion
olson|solon
oman|mona|moan
omen|moen
omens|meson
omicron|moronic
on|no
once|cone
oncoming|gnomonic
one|eon
ones|eons|nose
oneself|felones
only|lyon
ons|son
onside|edison
ontario|oration
oocyte|coyote
opal|palo
opec|cope
open|peon|nope
opener|reopen
openers|penrose
opens|epson
operant|protean
operants|paterson
operates|protease
opines|ponies
opposer|propose
optic|topic
optical|topical|capitol
opus|soup
opuses|spouse
oracles|solacer
orate|erato
oration|ontario
orb|rob
orbits|bistro
orbs|robs|sorb
orchis|choirs
ordain|inroad
ordains|inroads
ordeal|laredo|loader|reload
ordeals|reloads|loaders
orderer|reorder
ordinal|lorinda
ordinate|rationed
ore|o'er|roe
orestes|stereos
organ|argon|groan
organist|roasting
organs|sarong|groans
orient|tonier
oriental|relation
orients|stonier
orin|iron
orleans|salerno
os|so
oslo|solo
others|throes
ott|tot
otter|torte|toter
otters|tortes
otto|toot
ouch|chou
ought|tough
ounces|unesco
ours|sour
oust|outs
ouster|routes
ousting|outings
outbreak|breakout
outdraw|outward
outings|ousting
outline|elution
outlook|lookout
outlooks|lookouts
output|putout
outrun|runout
outs|oust
outsell|sellout
outside|tedious
outstand|standout
outtake|takeout
outward|outdraw
outwash|washout
outwork|workout
oval|olav
ovals|salvo
over|rove
overcoat|evocator
overdue|doeuvre|d'oeuvre
overhang|hangover
overrun|runover
overs|servo
overt|voter|trove
overtake|takeover
overturn|turnover
ovid|void
ow|wo
owe|woe
owes|woes
owl|low
owlet|towel
owls|lows|slow
owly|yowl
own|now|won
owned|endow
owners|worsen
owns|sown|nows|snow
oy|yo
oyster|storey
pace|cape
pacer|recap|caper
paces|space|capes
packer|repack
packers|repacks
paddler|peddlar
page|gape
paged|gaped
pages|gapes
pails|lapis
pains|spain
paint|inapt
painter|pertain|repaint
painters|pertains|repaints|pantries
paired|diaper|repaid
pairs|paris
pal|alp|lap
pale|leap|peal|plea
paled|pedal|plead
paler|pearl
pales|peals|leaps|sepal|pleas|lapse
palest|plates|staple|petals|pleats|pastel
palm|lamp
palms|lamps|psalm|plasm
palo|opal
paltry|raptly|partly
pam|amp|map
pamper|mapper
pan|nap
pane|neap|nape
panel|plane|nepal|penal
paneled|deplane
panelist|plainest
panels|planes|naples
panes|napes|aspen
panicle|pelican
pans|naps|span|snap
pansies|sapiens
panted|pedant
pantries|pertains|repaints|painters
paperer|prepare
papers|sapper
papery|prepay
par|rap
parasite|aspirate
parboil|bipolar
parcel|placer
parceled|replaced
parcels|scalper|clasper
parent|enrapt|entrap
parental|paternal|prenatal
parents|entraps
paris|pairs
park|karp
parks|spark
paroled|leopard
parrot|raptor
pars|raps|spar|rasp
part|trap|rapt|tarp
parted|prated|petard|depart
partied|pirated
parties|traipse|pastier|pirates
parting|prating
partisan|aspirant
partly|paltry|raptly
paso|soap
past|pats|spat|taps
paste|septa|spate|tapes
pastel|plates|staple|palest|petals|pleats
pastels|staples
pasteup|pupates
pasteur|pasture
pastier|traipse|parties|pirates
pasties|patsies
pasts|spats
pasture|pasteur
pasturer|raptures
pasty|patsy
pat|pta|apt|tap
pate|tape|peat
pated|adept|taped
pater|taper|prate
paternal|prenatal|parental
paterson|operants
pathogen|heptagon
paths|staph
patrol|portal
patrols|portals
patron|tarpon
patroness|transpose
pats|past|spat|taps
patsies|pasties
patsy|pasty
patterer|pretreat
patterns|transept
patters|spatter
pawner|enwrap
pawns|spawn
pay|yap
payer|repay
pays|spay
paz|zap
pea|ape
peach|cheap
peaks|speak|spake
peal|leap|plea|pale
peals|leaps|sepal|pleas|lapse|pales
pearl|paler
pearson|persona
peas|apes|apse
peat|tape|pate
pecks|speck
pecos|copes|scope|copse
pectin|incept
pedal|plead|paled
pedaled|pleaded
pedaling|pleading
pedals|pleads|lapsed
pedant|panted
peddlar|paddler
pedro|doper|roped|pored
peek|keep
peeks|keeps
peels|sleep
peerless|sleepers
peers|spree
pees|seep
pelican|panicle
pelter|petrel
peltry|pertly
pelts|slept|spelt
penal|plane|nepal|panel
penalty|aplenty
penrose|openers
peon|nope|open
peppier|preppie
pepsi|pipes
percale|replace
percept|precept
perfect|prefect
perform|preform
perils|lisper|pliers
period|dopier
peripatetic|precipitate
perish|reship
perle|repel|leper
perlite|reptile
permissible|impressible
permission|impression
permissive|impressive
permits|imprest
permutation|importunate
perry|pryer
perseus|peruses
persia|praise|aspire
person|posner
persona|pearson
pertain|painter|repaint
pertains|repaints|painters|pantries
pertly|peltry
pertness|serpents|presents
peru|pure
peruse|rupees
peruses|perseus
pervade|deprave
pervaded|depraved
pervades|depraves
peso|pose
pesos|posse|poses
pest|pets|sept|step
peste|steep
pester|preset
pesters|presets
pests|steps
petal|pleat|leapt|plate
petaled|pleated
petals|plates|staple|palest|pleats|pastel
petard|prated|parted|depart
petersen|pretense
petrel|pelter
petrol|replot
pets|sept|pest|step
pews|spew
phantom|hampton
phase|heaps|shape
phased|shaped
phases|shapes
phasing|shaping
phenolic|pinochle
phi|hip
phonic|chopin
phrase|sharpe|shaper
phrased|sharped|shepard
pickets|skeptic
pictures|piecrust
piebald|bipedal
piecrust|pictures
pier|ripe
piers|spire
pikes|spike
piled|plied
pilings|lisping
pillages|spillage
pills|spill
pin|nip
pincer|prince
pinhead|headpin
pinkish|kinship
pinnings|spinning
pinochle|phenolic
pins|snip|nips|spin
pintails|tailspin
pinto|point
pipers|sipper
pipes|pepsi
pipings|sipping
pique|equip
piraeus|upraise
pirated|partied
pirates|traipse|parties|pastier
pirogue|groupie
pisces|spices
piston|points
pit|tip
pits|spit|tips
placer|parcel
plainest|panelist
plains|spinal
plaint|pliant
plane|nepal|panel|penal
planes|panels|naples
planet|platen
planter|replant
plasm|lamps|psalm|palms
plaster|psalter|stapler
plasters|staplers
plastery|psaltery
plate|pleat|leapt|petal
platen|planet
plater|alpert
plates|staple|palest|petals|pleats|pastel
platings|stapling
platter|prattle
platters|splatter|prattles
plea|leap|peal|pale
plead|pedal|paled
pleaded|pedaled
pleading|pedaling
pleads|pedals|lapsed
pleas|peals|leaps|sepal|lapse|pales
please|elapse|asleep
pleased|elapsed
pleases|elapses
pleasing|elapsing
pleat|leapt|plate|petal
pleated|petaled
pleater|prelate
pleats|plates|staple|palest|petals|pastel
plebes|bleeps
plebian|biplane
plenum|lumpen
pliant|plaint
plied|piled
pliers|lisper|perils
ployed|deploy
plum|lump
plumed|lumped
plumier|lumpier
pluming|lumping
plums|slump|lumps
pluses|pulses
pocus|coups
poem|mope|pome
poems|mopes|epsom
poesy|sepoy|posey
poets|estop
pogo|goop
poincare|procaine
point|pinto
pointer|protein
pointers|proteins
points|piston
poises|posies
poisoned|poseidon
poisons|poisson
poisson|poisons
polis|spoil
polyp|loppy
polyps|sloppy
pome|poem|mope
ponders|respond
ponies|opines
pontiac|caption
pore|rope
pored|pedro|doper|roped
pores|prose|ropes|poser|spore
porosity|isotropy
portal|patrol
portals|patrols
ported|deport|redtop
porter|report
porters|reports
portions|positron|sorption
porto|troop
ports|strop|sport
pose|peso
posed|dopes
poseidon|poisoned
poser|prose|ropes|spore|pores
poses|posse|pesos
posey|sepoy|poesy
posh|hops|shop
posies|poises
posited|topside|deposit
positron|portions|sorption
posner|person
posse|poses|pesos
postage|gestapo
poster|presto
posters|prestos
posture|troupes|spouter
postured|proudest|sprouted
pouter|troupe|puerto
pouts|spout
pow|wop
praise|persia|aspire
praised|diapers|aspired|despair
praiser|repairs|aspirer
praises|aspires
pram|ramp
prate|pater|taper
prated|parted|petard|depart
prates|tapers|repast
prating|parting
prattle|platter
prattles|splatter|platters
prayers|sprayer
prays|spray|raspy
precept|percept
precipitate|peripatetic
precis|prices
precise|recipes
predate|tapered
predated|departed
predator|prorated|teardrop
predicts|scripted
prefect|perfect
preform|perform
prelate|pleater
preludes|repulsed
premie|empire
premiers|simperer
premise|empires
premised|simpered
prenatal|paternal|parental
prepare|paperer
prepay|papery
preppie|peppier
prescott|protects
presell|speller
present|repents|serpent
presents|serpents|pertness
preset|pester
presets|pesters
presider|reprised
presides|despiser|disperse
pressed|depress
presser|repress
presto|poster
prestos|posters
presume|supreme
pretense|petersen
pretreat|patterer
previous|viperous
prewar|warper
prexy|pyrex
prey|pyre
preys|pyres
priam|prima
prices|precis
prier|riper
prig|grip
prima|priam
primes|simper
primrose|promiser
prince|pincer
printer|reprint
printers|reprints|sprinter
prints|sprint
procaine|poincare
process|corpses
prom|romp
promise|imposer
promiser|primrose
proofer|reproof
propel|lopper
propose|opposer
prorated|teardrop|predator
prose|ropes|poser|spore|pores
proser|ropers
protean|operant
protease|operates
protects|prescott
protein|pointer
proteins|pointers
proudest|postured|sprouted
proust|stupor|sprout
provides|disprove
prude|duper
prudent|uptrend
pryer|perry
psalm|lamps|plasm|palms
psalter|plaster|stapler
psaltery|plastery
psi|sip
pta|apt|pat|tap
puc|cpu|cup
puerto|troupe|pouter
pulses|pluses
pulsion|upsilon
puns|spun
pupates|pasteup
pure|peru
puree|rupee
purest|erupts
purges|spurge
purists|stirups
purposes|supposer
purse|sprue|super
pursued|usurped
pursuer|usurper
pursuing|usurping
pus|sup|ups
putout|output
pyhrric|pyrrhic
pyle|yelp
pyre|prey
pyres|preys
pyrex|prexy
pyrrhic|pyhrric
python|typhon
quaestor|equators
quakes|squeak
quartets|squatter
quartile|requital
querier|require
quester|request
questor|torques
quickest|quickset
quickset|quickest
quids|squid
quiniela|aquiline
quito|quoit
quoit|quito
quoter|torque
rabbled|drabble|dabbler
rabic|carib|baric
race|acre|care
raced|cedar|cadre|cared|arced
racer|carer
racers|scarer
races|cares|scare|acres
racier|carrie
racket|tacker
rackets|stacker
racy|cray
radian|adrian
radic|dirac|acrid
radices|sidecar
radio|doria
radius|darius
radon|adorn
rae|era|are|ear
raffia|affair
rafters|strafer
raid|arid
rail|liar|lira|lair
railed|dialer|redial|derail
rails|lairs|liars|liras
raiment|minaret
raise|arise|aries|aires
raiser|sierra
raises|arises
raising|arising
raj|jar
raja|ajar
raked|drake
rakes|akers|asker
rale|real|lear|earl
ram|arm|mar
ramada|armada
rambled|marbled
rambler|marbler
rambles|marbles
rambling|marbling
ramie|maier|aimer|marie
ramo|roam
ramp|pram
ramped|damper
rancho|anchor|charon
rand|darn
randies|sardine|sandier
range|anger
ranger|garner
rangers|garners
ranges|angers
rangy|angry
rank|nark
ranked|darken
rankest|tankers
ranks|snark
ransom|manors
ranted|ardent
ranter|errant
rap|par
rapier|repair
rapped|dapper
raps|pars|spar|rasp
rapt|trap|part|tarp
raptly|paltry|partly
raptor|parrot
raptures|pasturer
rare|rear
rarebit|arbiter
rarest|raters|arrest|raster|starer
rarify|friary
rasa|sara
rascal|scalar|lascar|sacral
rascals|scalars
rasher|sharer
rashes|shears|shares
rasp|raps|pars|spar
rasps|spars
raspy|spray|prays
raster|raters|arrest|rarest|starer
rat|art|tar
rata|tara
ratchet|chatter
ratchets|chatters
rate|tear
rated|tread|dater|trade
rater|terra
raters|arrest|raster|rarest|starer
rates|stare|tears|aster
rationed|ordinate
ratline|entrail|latrine|reliant|retinal
rats|tars|arts|star|tsar
rattle|latter
raul|lura
rave|aver|vera
ravel|laver|velar
raven|verna
raves|saver|versa
ravine|naiver
ravined|invader
raw|war
rawest|waters|waster
rawness|answers
raws|wars
rayed|ready
raze|ezra
rca|arc|car
re|er
reabsorb|absorber
react|cater|crate|caret|trace|carte
reacted|created|catered
reaction|creation
reactive|creative
reactor|creator
reactors|creators
reacts|recast|traces|crates|caster
read|dear|erda|dare
reader|reared|reread|dearer
readjust|adjuster
reads|dares|dears
ready|rayed
reagent|negater|grantee
reagents|estrange|sergeant|grantees
real|lear|earl|rale
realest|relates|stealer
realign|aligner
realised|sidereal
realism|mailers
realist|saltier|retails
reality|irately|tearily
realizes|sleazier
reals|laser|lares
realtime|materiel
realtor|relator
ream|mare
reamers|smearer
reaming|mangier
reams|mares|maser|smear
rear|rare
reared|reread|dearer|reader
rearmed|dreamer
reason|senora
reawaken|awakener
rebate|berate|beater
rebated|berated|debater
rebating|berating
rebound|bounder
rebuild|builder
rebuilds|builders
rebus|burse
rebut|tuber|brute|buret
recall|cellar|caller
recalls|cellars|callers
recant|trance|canter|nectar|cretan
recanted|decanter|cantered
recap|caper|pacer
recast|traces|crates|caster|reacts
recasts|casters|actress
recede|decree
receded|decreed
recedes|decrees|seceder
received|deceiver
recent|center
recheck|checker
recife|fierce
recipes|precise
recital|article
recitals|articles
reclaim|miracle|claimer
reclaims|miracles
reclines|licenser|silencer
recoin|enrico|coiner
reconvey|conveyer
record|corder
recount|trounce|counter
recounts|trounces|counters|construe
recourse|resource
recover|coverer
recruits|crustier
rectify|certify
rectus|custer
recur|curer
recusant|centaurs|etruscan
recuse|cereus|rescue|secure
redact|carted|traced
redesign|resigned|designer
redhead|adhered
redial|railed|dialer|derail
redleg|ledger
redness|senders|resends
redone|doreen
redoubt|obtrude|doubter
redound|rounded
redraw|warred|reward|drawer
redress|dresser
redtop|deport|ported
reduces|rescued|secured|seducer
reed|deer
reeds|deers|seder
reef|free
reefed|feeder
reefs|frees
reeks|esker
reel|leer
reeled|leered
reels|leers
reemploy|employer
reenlist|enlister|listener
reenter|enterer
reeves|severe
refer|freer
referred|deferrer
refill|filler
refills|fillers
refine|ferine
refined|definer
refinish|finisher
refocus|focuser
reforest|forester|fosterer
reform|former
refract|crafter
refresh|fresher
refuel|fueler
refunded|underfed
regain|gainer|regina
regal|large|lager|alger|glare
regalia|algeria
regally|allergy|gallery|largely
regard|grader|gerard
regarded|degrader
regards|graders
regina|gainer|regain
region|ignore
regions|ignores
regreet|greeter
reground|grounder
regroup|grouper
regrow|grower
reich|erich
reign|niger|renig
reigns|singer|resign|signer
reined|nereid|denier
reins|resin|risen|rinse|siren
rejoin|joiner
reknit|tinker
relate|elater
related|altered|treadle|alerted
relater|alterer
relates|realest|stealer
relation|oriental
relator|realtor
relearn|learner
relearns|learners
released|resealed
relents|nestler
reliably|blearily
reliant|entrail|ratline|latrine|retinal
relics|slicer
relieves|elsevier
relished|shielder
relishes|heirless
relive|eviler|revile
relives|reviles|servile
reliving|reviling
reload|laredo|ordeal|loader
reloads|ordeals|loaders
relocate|corelate
rely|lyre
remain|airmen|marine
reman|namer
remanded|demander
remark|kramer|marker
remarks|markers
rematch|matcher
remind|minder
remit|miter|mitre|timer|merit
remodel|modeler
remote|meteor
remus|serum|muser
rena|near|earn
renal|learn|arlen
rename|meaner
renamed|meander|amender
renault|neutral|laurent
rend|nerd
rending|grinned
renege|greene
reneged|greened
reneging|greening
reness|sneers
renew|newer
renig|niger|reign
renigged|gingered
rent|tern
rental|altern|antler
rentals|sternal|antlers
rented|tender
renters|sterner
rents|stern|ernst
renumber|numberer
reopen|opener
reorder|orderer
repack|packer
repacks|packers
repaid|diaper|paired
repaint|painter|pertain
repaints|pertains|painters|pantries
repair|rapier
repairs|aspirer|praiser
repartee|repeater
repast|tapers|prates
repay|payer
repeal|leaper
repeater|repartee
repel|leper|perle
repels|lepers
repents|present|serpent
rephrase|reshaper
replace|percale
replaced|parceled
replant|planter
replica|caliper
replicas|calipers
replot|petrol
report|porter
reports|porters
reposing|spongier
repress|presser
reprint|printer
reprints|printers|sprinter
reprise|respire
reprised|presider
reproof|proofer
reptile|perlite
repulsed|preludes
reputed|erupted
reputing|erupting
request|quester
require|querier
requital|quartile
reread|reared|dearer|reader
rereward|rewarder
reruns|nurser
resail|serial|israel|sailer
resale|sealer
rescale|cereals
rescind|cinders|discern
rescue|cereus|recuse|secure
rescued|reduces|secured|seducer
rescuer|securer
rescues|secures
resealed|released
research|searcher
reseed|seeder
resend|sender|denser
resends|redness|senders
resent|enters|tenser|ernest|nester
reserve|reverse|severer
reserved|reversed|deserver
reserves|reverses
reset|terse|ester|steer|trees
reseted|steered
reseter|steerer
resets|steers
reshaper|rephrase
reship|perish
reside|desire
resident|inserted
resider|desirer
resides|desires
resign|singer|reigns|signer
resigned|designer|redesign
resigns|signers|ingress|singers
resin|reins|risen|rinse|siren
resinous|neurosis
resins|rinses|sirens
resist|sister
resisted|sistered
resistor|sorriest
resort|sorter|roster
resorted|restored
resorter|restorer
resorts|sorters
resound|sounder
resounds|dourness
resource|recourse
respect|sceptre|scepter
respects|scepters
respire|reprise
respond|ponders
rested|desert
rester|terser
resting|stinger
restock|stocker|rockets
restored|resorted
restorer|resorter
restrict|critters|stricter
rests|tress
results|rustles
retail|tailer
retailed|detailer
retails|realist|saltier
retain|retina
retained|detainer
retard|tarred|darter|trader
retards|starred|traders
retch|chert
retest|setter|tester|street
rethink|thinker
retied|dieter|tiered
retina|retain
retinal|entrail|ratline|latrine|reliant
retinue|uterine|reunite
retort|rotter
retrace|caterer|terrace
retraced|cratered|terraced
retraces|terraces
retread|treader
retreat|treater
retrial|trailer
retry|terry
retuned|tenured|denture
return|turner
reub|rube
reunite|uterine|retinue
reveal|leaver
reveals|several
revel|lever
reveled|levered
revels|levers
reverse|reserve|severer
reversed|reserved|deserver
reverses|reserves
revet|evert
review|viewer
reviews|viewers
revile|eviler|relive
reviled|deliver
reviles|relives|servile
reviling|reliving
revised|derives|diverse|deviser
reward|warred|redraw|drawer
rewarder|rereward
rewards|drawers
rewind|winder
rewinds|winders
rework|worker
reworks|workers
rhea|hear|hare|hera
rhesus|rushes|ushers
rhine|henri
rhoda|hoard
rhode|horde
rhodes|hordes|shored
rhodium|humidor
ribald|bridal
ribbed|bribed
ribber|briber
ribbing|bribing
ribbon|robbin
ribbons|robbins
rice|eric
ricer|crier
rices|cries
ridden|rinded
riddled|diddler
ridge|dirge
ridged|girded|dirged
ridges|dirges
rife|fire
rift|frit
rifts|first
rigged|digger
rile|lire|lier
rime|emir|mire
rimmed|dimmer
rinded|ridden
rinse|resin|reins|risen|siren
rinsed|snider|diners
rinses|resins|sirens
riot|trio|tori
rioted|editor|triode
rioters|roister
rioting|ignitor
riots|trios
ripe|pier
ripely|ripley
ripened|dnieper
riper|prier
ripley|ripely
ripped|dipper
rise|sire
risen|resin|reins|rinse|siren
rises|sires
risk|irks
rite|tier|tire
rited|tried|tired
rites|tries|tires|tiers
ritter|triter
rival|viral
riven|ervin
rivets|strive
road|dora
roadbed|boarded
roam|ramo
roan|nora
roared|adorer
roast|astor|astro
roasting|organist
rob|orb
robbin|ribbon
robbins|ribbons
robe|bore
robed|bored
roberta|aborter
robes|sober|bores
robs|sorb|orbs
rock|cork
rocked|corked|docker
rocker|corker
rockers|corkers
rockets|stocker|restock
rocks|corks
roe|o'er|ore
rogue|rouge
roister|rioters
roland|ronald|arnold
role|lore
roles|loser
roman|manor|moran|norma
romance|cameron
romano|maroon
rome|more
romeo|moore
romp|prom
ron|nor
ronald|roland|arnold
rondo|donor
rood|door|odor
room|moor
roomed|moored
rooms|moors
roost|torso|roots
roots|torso|roost
rope|pore
roped|pedro|doper|pored
ropers|proser
ropes|prose|poser|spore|pores
rosa|sora|soar|oars
rosen|senor|snore
roses|sores
rosetta|rotates|toaster
rosiest|stories|sterios
rosin|irons
rosined|indorse
roster|sorter|resort
rotates|toaster|rosetta
rote|tore
roth|thor
rots|sort
rotted|dotter
rotter|retort
rouge|rogue
rounded|redound
roused|soured
roust|tours|routs|torus
rout|tour
routed|detour|toured
router|tourer
routes|ouster
routs|tours|torus|roust
rove|over
roved|dover|drove
rowdier|worried|wordier
rowdies|dowries|weirdos
rowdily|wordily
rowdy|dowry|wordy
rowe|wore
rowed|dower
rowers|worser
rowland|waldron
royalist|solitary
royce|corey
rubbed|dubber
rubble|burble|lubber
rubbled|burbled
rubbling|burbling
rube|reub
rubies|buries|bruise|busier
ruble|bluer|burle
ruby|bury
ruder|durer
rudest|rusted|duster
rues|suer|ruse|user|sure
rugged|grudge
ruined|inured
rule|lure
ruled|lured
ruler|lurer
rules|lures
rumble|lumber
rumbles|lumbers|slumber
rummies|immures
rumple|lumper
run|urn
runes|nurse
runic|incur
runout|outrun
runover|overrun
runs|urns
runt|turn
runway|unwary
rupee|puree
rupees|peruse
ruse|suer|rues|user|sure
rushes|ushers|rhesus
russ|ussr
russet|estrus|surest
russo|sours
rust|ruts
rusted|rudest|duster
rustic|curtis|citrus
rustled|strudel
rustles|results
ruth|hurt|thru
ruthless|hustlers
ruts|rust
ryan|nary|yarn
ryder|dryer
sable|bales|basel
saccade|cascade
sachem|schema
sachet|scathe|cheats|chaste
sacheted|detaches
sack|cask
sacker|creaks
sacral|scalar|lascar|rascal
sacred|cedars|scared
sad|ads
sadder|dreads
saddler|ladders
sadie|aside|aides|ideas
safer|fears|fares
safest|feasts
sag|gas
sage|ages
sages|gases
said|dais|aids
sail|ails|lisa|sial
sailable|isabella
sailed|ladies|ideals
sailer|serial|resail|israel
sails|silas|sisal
saintly|nastily
sale|seal|lase
salerno|orleans
sales|seals
salient|saltine|entails|elastin
saline|silane|aliens
saliva|avails
sallow|allows
salon|loans|sloan
salt|slat|last
salted|slated|deltas|lasted
saltier|realist|retails
saltine|salient|entails|elastin
salting|slating|lasting
salts|slats|lasts
salve|slave
salves|slaves
salvo|ovals
same|mesa|ames|seam
sample|maples
samson|masons
sana|nasa
sanction|contains
sander|snared
sandier|randies|sardine
sane|sean
saner|earns|snare|nears
sang|snag
sanitate|astatine
sanity|satiny
sap|spa
sapiens|pansies
sapling|lapsing
sapper|papers
sappier|apprise
sara|rasa
sardine|randies|sandier
sardines|aridness
sargent|strange
sari|airs
sarong|organs|groans
sashed|shades|dashes
satchel|latches
sate|teas|east|seat|eats
sated|stade|dates|stead
sating|giants
satiny|sanity
satyr|trays|stray
sauce|cause
saucer|causer
sauces|causes
sault|latus|tulsa|talus
saunter|natures
save|vase
saver|raves|versa
saves|vases
saviour|various
saw|was
sawer|wears|swear|wares
sawyer|swayer
sayer|years|ayers
scab|cabs
scalar|lascar|sacral|rascal
scalars|rascals
scale|laces
scaled|decals
scaler|clears
scalped|clasped
scalper|parcels|clasper
scalping|clasping
scalps|clasps
scam|cams
scamp|camps
scamper|campers
scan|cans
scant|canst
scantier|canister
scapular|capsular
scar|cars|arcs
scare|races|cares|acres
scared|cedars|sacred
scarer|racers
scares|caress
scarier|carries
scarlet|clarets|cartels
scat|cats|acts|cast
scathe|cheats|chaste|sachet
scent|cents|csnet
scented|descent
scepter|respect|sceptre
scepters|respects
sceptre|respect|scepter
schema|sachem
schematic|catechism
schubert|butchers
scion|icons|coins|sonic
scoffer|coffers
scold|colds|clods
scolded|coddles
scone|cones
scoop|coops
scooper|coopers
scope|copes|copse|pecos
scopes|copses
score|cores|corse
scored|credos
scorers|crosser
scorn|corns
scorner|corners
scot|cost|cots
scoured|coursed
scourer|courser
scow|cows
scranton|cranston
scrawl|crawls
scrawler|crawlers
scream|creams
screed|creeds
scrimage|grimaces
scrimp|crimps
scripted|predicts
scrub|curbs
scuff|cuffs
scuffles|cuffless
scuttle|cutlets
scythe|chesty
seabed|debase
seabird|sidebar
seadog|dosage
seahorse|seashore
seal|sale|lase
sealed|leased
sealer|resale
sealing|leasing
seals|sales
seam|mesa|ames|same
sean|sane
seance|seneca|encase
sear|ears|sera|ares|eras
search|arches|chaser
searcher|research
seashore|seahorse
seaside|disease
seat|sate|teas|east|eats
seatbelt|testable
seated|sedate|teased
seater|easter|eaters|teresa|teaser
seating|teasing|easting
secant|ascent|stance|enacts
secants|stances
seceder|decrees|recedes
seconder|censored
sectarian|cartesian|ascertain
section|notices
sector|escort|corset
sectored|corseted|escorted
sectors|escorts|corsets
secure|cereus|recuse|rescue
secured|rescued|reduces|seducer
securer|rescuer
secures|rescues
sedan|andes|deans
sedate|seated|teased
sedative|deviates
seder|deers|reeds
sedge|edges
sedition|editions
seduce|deuces
seduced|deduces
seducer|rescued|reduces|secured
seeder|reseed
seedily|eyelids
seedpod|deposed
seep|pees
seethed|sheeted
seething|sheeting
seidel|diesel
seldom|models
select|elects
selector|electors
selenite|enlistee
self|elfs
selfish|hisself
sellout|outsell
selves|vessel
senator|treason
send|dens|ends
sender|resend|denser
senders|redness|resends
sending|endings
seneca|seance|encase
senegal|angeles
senior|nosier
senor|rosen|snore
senora|reason
sense|essen
sensing|ensigns
sent|tens|nest|nets
seoul|louse
sepal|peals|leaps|pleas|lapse|pales
sepoy|poesy|posey
sept|pets|pest|step
septa|paste|spate|tapes
sera|sear|ears|ares|eras
serfdom|deforms
sergeant|reagents|estrange|grantees
serial|resail|israel|sailer
serials|airless
serif|fries|fires
serine|eisner
serpent|repents|present
serpents|pertness|presents
serrated|arrested
serum|remus|muser
serval|slaver
servant|taverns
serve|verse|veers|sever
served|versed
server|verser
serves|verses|severs
servile|reviles|relives
servo|overs
setoff|offset
setter|retest|tester|street
setting|testing
settings|testings
settler|letters|trestle
settlers|trestles
setup|upset
setups|upsets
seven|evens
sever|verse|serve|veers
several|reveals
severe|reeves
severed|deserve
severer|reserve|reverse
severn|nerves
severs|verses|serves
sewn|news
shad|dash
shaddock|haddocks
shade|heads|hades
shaded|dashed
shader|dasher|shared
shades|sashed|dashes
shading|dashing
shafer|afresh
shale|leash|heals
shaley|halsey|ashley
shall|halls
shalt|halts|stahl
sham|hams|mash
shaman|ashman
shamed|mashed
shames|mashes
shaming|mashing
shammer|hammers
shams|smash
shan't|hasn't
shape|phase|heaps
shaped|phased
shaper|phrase|sharpe
shapes|phases
shaping|phasing
share|hears|shear|hares|asher
shared|dasher|shader
sharer|rasher
shares|rashes|shears
shari|hairs
shark|harks
sharp|harps
sharpe|phrase|shaper
sharped|shepard|phrased
sharper|harpers
shave|haves
shaven|havens
shaver|havers
shaw|wash
shawl|walsh
shay|hays|ashy
she'd|shed
she'll|hells|shell
shear|hears|hares|share|asher
sheared|adheres|headers
shearer|hearers
shears|rashes|shares
sheath|heaths
sheave|heaves
shed|she'd
sheet|these
sheeted|seethed
sheeting|seething
sheets|theses
sheik|hikes
sheila|elisha
shell|hells|she'll
shepard|sharped|phrased
sherd|herds|shred
sherrill|shriller
shied|hides
shielder|relished
shiest|heists|thesis
shill|hills
shindig|dishing
shine|hines
shiner|shrine
shingle|english
ship|hips
shire|hires|heirs
shires|hisser
shiver|shrive
shoal|halos
shoat|oaths
shock|hocks
shocker|chokers
shoe|hoes|hose
shoed|hosed
shoes|hoses
shone|hones
shook|hooks
shop|hops|posh
shored|hordes|rhodes
shores|horses
shortie|hoister
shout|south
shouts|souths
shovel|hovels
shover|shrove|hovers
show|hows
shred|herds|sherd
shriek|hikers|shrike
shrike|shriek|hikers
shriller|sherrill
shrine|shiner
shrive|shiver
shrove|shover|hovers
shrub|brush
shun|huns
shunt|hunts
shunter|hunters
shut|tush|huts|thus
si|is
sial|ails|lisa|sail
siam|aims|sima
sian|ansi
sib|bis
sibyl|sybil
side|dies|ides
sidearm|admires|misread
sidebar|seabird
sideboard|broadside
sidecar|radices
sideman|maidens
sidereal|realised
sideway|wayside
sideways|waysides
sidle|idles|slide|delis
sidles|slides
sidling|sliding
sidney|disney
siemens|nemesis
siena|anise
sienna|inanes|insane
sierra|raiser
sifter|strife
sighing|higgins
sign|gins|sing
signal|aligns
signaled|dealings
signed|deigns|design|singed
signer|singer|reigns|resign
signers|ingress|resigns|singers
signet|ingest
signing|singing
signs|sings
silane|aliens|saline
silas|sisal|sails
silence|license
silenced|licensed|declines
silencer|licenser|reclines
silences|licenses
silent|inlets|listen|tinsel|enlist
silently|tinselly
silents|listens|enlists
silicone|isocline
sill|ills
silo|soil|lois|oils
silos|soils
silty|styli
silver|sliver|livers
silvered|slivered|delivers
silvers|slivers
silvery|slivery
sima|aims|siam
similes|missile
simmered|immersed
simon|minos
simp|imps
simper|primes
simpered|premised
simperer|premiers
simpers|impress
simple|impels
sims|miss
sin|ins
sinew|swine|wines
sing|gins|sign
singed|deigns|signed|design
singer|reigns|resign|signer
singers|signers|ingress|resigns
singing|signing
singlet|glisten|tingles
singling|slinging
singly|lyings
sings|signs
sink|skin|inks
sinks|skins
sinned|dennis
sinning|innings
sinter|insert
sip|psi
sipper|pipers
sipping|pipings
sir|irs
sire|rise
siren|resin|reins|risen|rinse
sirens|resins|rinses
sires|rises
sisal|silas|sails
sister|resist
sistered|resisted
sit|its
sitar|stair|astir
site|ties
sited|diets|edits|tides
situ|suit
situs|suits
siva|visa|avis
sizes|zeiss
skat|task
skate|takes|stake|steak|keats
skated|tasked|staked
skates|steaks|stakes
skelter|kestrel
skeptic|pickets
skied|dikes
skiers|kisser
skill|kills
skin|inks|sink
skins|sinks
skip|kips
skipper|kippers
skirted|striked
skirter|striker
skis|kiss
skit|kits
slab|labs
slack|lacks
slain|nails|snail
slam|alms
slander|snarled
slang|glans
slanted|dentals
slat|salt|last
slate|steal|teals|least|tales|stale
slated|deltas|salted|lasted
slater|alerts|alters|staler
slating|salting|lasting
slats|salts|lasts
slave|salve
slaver|serval
slaves|salves
slaw|laws
sleazier|realizes
sledge|ledges
sledging|geldings
sleek|keels
sleep|peels
sleepers|peerless
sleet|steel
sleety|steely
sleeve|levees
slender|lenders
slept|spelt|pelts
sleuth|hustle
slicer|relics
slick|licks
slid|lids
slide|sidle|idles|delis
slider|idlers
slides|sidles
sliding|sidling
slight|lights
slighted|delights
slime|smile|limes|miles
slimed|smiled|misled
sliming|smiling
slinger|lingers
slinging|singling
slinked|kindles
sliver|silver|livers
slivered|silvered|delivers
slivers|silvers
slivery|silvery
sloan|loans|salon
sloe|sole|lose
slop|lops
sloppy|polyps
slot|lost|lots
sloth|holst
slough|ghouls
slow|lows|owls
slower|lowers
slowness|snowless
slugger|gurgles
sluices|celsius
slumber|rumbles|lumbers
slump|lumps|plums
slung|lungs
slyest|styles
small|malls
smart|marts
smarter|armrest
smartie|artemis
smarting|migrants
smash|shams
smasher|mashers|marshes
smashing|mashings
smatter|matters
smear|mares|maser|reams
smearer|reamers
smelt|melts
smile|slime|limes|miles
smiled|slimed|misled
smiling|sliming
smite|emits|items|times|mites
smiter|merits|timers|mister
smiting|misting
smock|mocks
smokier|irksome
smug|mugs|gums
smugger|muggers
snag|sang
snail|nails|slain
snap|naps|pans|span
snapped|appends
snaps|spans
snare|earns|saner|nears
snared|sander
snark|ranks
snarled|slander
sneers|reness
snide|dines
snidely|lindsey
snider|rinsed|diners
snip|nips|pins|spin
snipes|spines
snips|spins
snitcher|christen
snook|nooks
snore|rosen|senor
snored|drones
snorkel|snorkle
snorkle|snorkel
snot|tons
snow|sown|nows|owns
snowed|endows
snowless|slowness
snyaptic|synaptic
so|os
soak|oaks
soap|paso
soar|sora|oars|rosa
soared|adores
sobbing|gibbons
sober|robes|bores
sobered|bedsore
sobs|boss
socratic|acrostic
sod|dos
sofa|oafs
softer|fortes|foster|forest
soil|lois|oils|silo
soiled|isolde|oldies
soils|silos
solacer|oracles
sole|lose|sloe
soles|loess|loses
solicit|colitis
solid|idols
solitary|royalist
soliton|lotions
solo|oslo
soloing|loosing
solon|olson
solute|tousle
solutes|tousles
soma|amos
somatic|atomics
somber|sombre
sombre|somber
son|ons
sonar|arson
sonic|icons|coins|scion
sonless|lessons
sonly|lyons
sony|nosy
sora|soar|oars|rosa
sorb|robs|orbs
sores|roses
sorption|portions|positron
sorriest|resistor
sort|rots
sortable|storable
sorter|resort|roster
sorters|resorts
sought|toughs
souled|loused
sounder|resound
soup|opus
sour|ours
source|course|crusoe
sources|sucrose|courses
soured|roused
sours|russo
south|shout
souths|shouts
sowed|dowse
sower|worse|swore
sown|nows|snow|owns
spa|sap
space|paces|capes
spain|pains
spake|peaks|speak
span|naps|pans|snap
spans|snaps
spar|raps|pars|rasp
spark|parks
spars|rasps
spat|pats|past|taps
spate|paste|septa|tapes
spats|pasts
spatter|patters
spawn|pawns
spawning|wingspan
spay|pays
speak|peaks|spake
speck|pecks
spector|copters
spectra|carpets
speech|cheeps
speller|presell
spelt|slept|pelts
sperry|spryer
spew|pews
spheric|ciphers
spica|aspic
spices|pisces
spike|pikes
spill|pills
spillage|pillages
spilled|dispell
spilt|split
spin|snip|nips|pins
spinal|plains
spindled|splendid
spines|snipes
spinning|pinnings
spins|snips
spire|piers
spit|pits|tips
spitter|tipster
splatter|prattles|platters
splendid|spindled
split|spilt
spoil|polis
spongier|reposing
spore|prose|ropes|poser|pores
sport|strop|ports
sported|deports
spouse|opuses
spout|pouts
spouter|troupes|posture
spray|prays|raspy
sprayer|prayers
spree|peers
sprig|grips
sprint|prints
sprinter|printers|reprints
sprout|stupor|proust
sprouted|postured|proudest
sprue|purse|super
spryer|sperry
spun|puns
spurge|purges
squatter|quartets
squeak|quakes
squeal|equals
squid|quids
squinty|nyquist
stab|tabs|bast|bats
stable|tables|bleats
stabled|blasted
stabler|blaster
stabling|blasting
stack|tacks
stacker|rackets
stade|dates|stead|sated
stag|gast|tags
stage|gates
stager|greats|grates
stagger|gagster
staggers|gagsters
stahl|halts|shalt
stair|astir|sitar
stake|takes|steak|skate|keats
staked|tasked|skated
stakes|steaks|skates
stale|steal|teals|least|tales|slate
staler|alerts|alters|slater
stalk|talks
stalker|talkers
stan|tans|ants
stance|ascent|secant|enacts
stances|secants
standout|outstand
stank|tanks
staph|paths
staple|plates|palest|petals|pleats|pastel
stapler|plaster|psalter
staplers|plasters
staples|pastels
stapling|platings
star|tars|arts|rats|tsar
starch|charts
stare|rates|tears|aster
stared|treads|trades
starer|raters|arrest|raster|rarest
starred|traders|retards
stars|tsars
starve|vaster
state|taste
stated|tasted
stater|taster|treats
states|tastes
static|attics
stating|tasting
statue|astute
stayed|steady
stayer|estray
staying|stygian
stead|stade|dates|sated
steady|stayed
steak|takes|stake|skate|keats
steaks|stakes|skates
steal|teals|least|tales|stale|slate
stealer|realest|relates
stealing|genitals
steam|meats|mates|teams
steel|sleet
steeled|deletes
steeling|gentiles
steely|sleety
steep|peste
steer|terse|ester|reset|trees
steered|reseted
steerer|reseter
steers|resets
stefan|fasten
stein|tines|inset
steiner|entries
stem|mets
stencil|clients
step|pets|sept|pest
steps|pests
stereos|orestes
sterios|stories|rosiest
stern|ernst|rents
sternal|rentals|antlers
sterner|renters
steroid|storied|editors
steven|events
stew|west|wets
stewart|swatter
stewing|twinges
stifle|itself|filets
stigmata|astigmat
stile|tiles|islet
stiles|islets
still|tills
stilt|tilts
stinger|resting
stingray|straying
stink|knits
stinker|tinkers
stint|tints
stipple|tipples
stirrup|irrupts
stirups|purists
stocked|dockets
stocker|restock|rockets
stogie|egoist
stogies|egoists
stoled|oldest
stoll|tolls
stonier|orients
stony|tyson
stopband|bandstop
stopper|toppers
stopping|toppings
storable|sortable
storey|oyster
storied|steroid|editors
stories|rosiest|sterios
storm|strom
stove|votes|vetos
stow|twos|tows
strafe|faster|afters
strafer|rafters
strait|artist|traits
straits|artists|tsarist
strange|sargent
straw|swart|warts
stray|satyr|trays
straying|stingray
street|setter|retest|tester
streets|tersest
stressed|desserts
strew|wrest
striate|tastier
stricter|restrict|critters
strife|sifter
striked|skirted
striker|skirter
strive|rivets
striven|inverts
stroll|trolls
strom|storm
stromberg|bergstrom
strop|sport|ports
strove|voters
struck|trucks
strudel|rustled
strum|sturm
strumpet|trumpets
strung|grunts
strut|trust
struter|truster|turrets
struts|trusts
stub|tubs|bust
stubs|busts
stud|dust
student|stunted
studies|tissued
study|dusty
stumble|tumbles
stumbler|tumblers
stun|nuts
stunted|student
stupor|proust|sprout
sturm|strum
stygian|staying
styles|slyest
styli|silty
sub|bus
sublet|subtle|bluest|bustle
subs|buss
subtle|bluest|sublet|bustle
succor|crocus|occurs
sucess|cusses
sucrose|courses|sources
sue|use
sued|deus|used|dues
suer|ruse|rues|user|sure
sues|uses
suez|zeus
sugar|argus
suing|using
suit|situ
suites|tissue
suits|situs
sumatra|traumas
sums|muss
sumter|muster
sunder|nursed
sunlight|hustling
sunlit|insult
sunrise|insures
sup|pus|ups
super|purse|sprue
supper|uppers
supposer|purposes
supreme|presume
sure|suer|ruse|rues|user
surest|estrus|russet
surf|furs
surge|urges
surging|urgings
surmise|mussier
surname|manures
susie|issue
suture|uterus
swaddle|waddles|dawdles
swag|wags
swage|wages
swang|gnaws
swarm|warms
swart|straw|warts
swat|wast
swath|whats|thaws
swatter|stewart
sway|yaws|ways
swayer|sawyer
swear|wears|wares|sawer
sweat|waste
sweatier|weariest
sweats|wastes
swedish|swished
sweep|weeps
swell|wells
swelt|welts
swelter|wrestle
swig|wigs
swill|wills
swindled|dwindles
swindles|windless|wildness
swine|sinew|wines
swing|wings
swished|swedish
swoop|woops
swore|worse|sower
sybarite|bestiary
sybil|sibyl
synaptic|snyaptic
szilard|lizards
ta|at
tab|bat
table|bleat
tables|bleats|stable
tablet|battle
tablets|battles
tabs|bast|bats|stab
tabu|abut|tuba
tacit|attic
tacitly|cattily
tacker|racket
tacks|stack
taco|coat
tacos|costa|coast|ascot|coats
tactile|lattice
tag|gat
tagged|gadget
tags|gast|stag
tailcoat|coattail
tailed|dilate|detail
tailer|retail
tailored|idolater
tailspin|pintails
take|teak|kate
takeout|outtake
takeover|overtake
takes|stake|steak|skate|keats
tale|teal|late
talent|latent
talents|latents
tales|steal|teals|least|stale|slate
talkers|stalker
talks|stalk
tallowy|tollway
talon|tonal|alton
talus|latus|tulsa|sault
tam|mat
tame|mate|team|meat
tamed|mated
tamer|mater
taming|mating
tan|ant|nat
tank|kant
tankers|rankest
tanks|stank
tannest|tenants
tans|stan|ants
tansy|nasty
tao|oat
taos|oats
tap|pta|apt|pat
tape|peat|pate
taped|adept|pated
taper|pater|prate
tapered|predate
tapers|prates|repast
tapes|paste|septa|spate
taps|pats|past|spat
tar|art|rat
tara|rata
tardier|tarried
tarp|trap|part|rapt
tarpon|patron
tarred|darter|trader|retard
tarried|tardier
tars|arts|star|rats|tsar
task|skat
tasked|skated|staked
taste|state
tasted|stated
taster|treats|stater
tastes|states
tastier|striate
tasting|stating
tate|teat
tater|tetra|treat
taunted|attuned
taverns|servant
tawnier|tinware
taxer|extra
taxes|texas
tea|ate|eat|eta
teach|cheat
teacher|cheater|hectare
teachers|hectares|cheaters
teaches|escheat
teaching|cheating
teak|kate|take
teal|late|tale
teals|steal|least|tales|stale|slate
team|tame|mate|meat
teaming|mintage
teams|steam|meats|mates
tear|rate
teardrop|prorated|predator
teared|derate
tearily|irately|reality
tears|rates|stare|aster
teas|sate|east|seat|eats
teased|sedate|seated
teasel|elates
teaser|easter|eaters|teresa|seater
teasing|seating|easting
teat|tate
tech|etch
tedious|outside
teem|meet|mete
teeming|meeting
teems|meets|metes
teheran|hearten|earthen
tehran|anther
ten|net
tenants|tannest
tend|dent
tended|dented
tender|rented
tending|denting
tendon|denton
tendril|trindle
tends|dents
tenor|noter|toner|notre
tens|sent|nest|nets
tensed|nested
tenser|enters|resent|ernest|nester
tensing|nesting
tension|intones
tentative|attentive
tented|detent|netted
tenter|netter
tenting|netting
tenure|neuter
tenured|retuned|denture
tequila|liquate
terbium|imbrute
teresa|easter|eaters|teaser|seater
terminal|tramline
termini|interim
tern|rent
terra|rater
terrace|caterer|retrace
terraced|cratered|retraced
terraces|retraces
terry|retry
terse|ester|steer|reset|trees
terser|rester
tersest|streets
testable|seatbelt
tested|detest
tester|setter|retest|street
testing|setting
testings|settings
tetra|treat|tater
texas|taxes
thaw|what
thaws|whats|swath
thayer|earthy|hearty
the|eth
thea|hate|heat
theater|thereat
theatric|chattier
thebes|behest
thelma|hamlet
there|three|ether
thereat|theater
therein|neither
theresa|heaters
these|sheet
theses|sheets
thesis|heists|shiest
thicken|kitchen
thickens|kitchens
thickest|thickets|thickset
thickets|thickest|thickset
thickset|thickets|thickest
thigh|hight
thin|hint
thing|night
things|nights
thinker|rethink
thins|hints
tho|hot
thor|roth
those|ethos
thousand|handouts
thread|dearth|hatred
threads|hardest|trashed
threat|hatter
three|there|ether
threes|ethers|hester|esther
throb|broth
throbs|broths
throes|others
throw|worth
throwing|ingrowth
thru|hurt|ruth
thrust|truths
thuban|bhutan
thus|tush|huts|shut
ti|it
tiara|atria
tiber|biter|tribe
tic|cit
tide|diet|edit|tied
tides|sited|diets|edits
tidiness|insisted
tidying|dignity
tied|diet|edit|tide
tieing|ignite
tier|tire|rite
tiered|dieter|retied
tiers|rites|tries|tires
ties|site
tike|kite
til|lit
tilde|tiled
tiled|tilde
tiler|liter
tiles|islet|stile
tills|still
tilter|litter
tilts|stilt
tim|mit
timber|timbre
timbre|timber
time|item|emit|mite
timed|demit
timeline|ilmenite
timer|miter|mitre|remit|merit
timers|smiter|merits|mister
times|smite|emits|items|mites
timon|minot
tin|nit
tina|ain't|anti
tineal|entail
tines|stein|inset
tingled|glinted
tingles|singlet|glisten
tingling|glinting
tinker|reknit
tinkers|stinker
tinned|intend|indent
tinner|intern
tins|isn't
tinsel|inlets|listen|silent|enlist
tinseled|listened|enlisted
tinselly|silently
tints|stint
tinware|tawnier
tip|pit
tipples|stipple
tips|pits|spit
tipster|spitter
tire|tier|rite
tired|rited|tried
tires|rites|tries|tiers
tissue|suites
tissued|studies
toady|today
toaster|rotates|rosetta
tobago|bogota
today|toady
toed|dote
toenail|elation
tog|got
toga|goat
toilet|lottie
told|dolt
tolls|stoll
tollway|tallowy
tom|mot
tome|mote
toms|mots|most
ton|not
tonal|alton|talon
tone|note
toned|noted
toner|noter|tenor|notre
toni|into|oint
tonier|orient
toning|noting
tonk|knot
tons|snot
toot|otto
topic|optic
topical|optical|capitol
toppers|stopper
toppings|stopping
topside|posited|deposit
topsides|deposits
topsy|typos
tore|rote
tori|trio|riot
tornado|donator
torpedo|trooped
torque|quoter
torques|questor
torso|roots|roost
tort|trot
torte|otter|toter
tortes|otters
torus|tours|routs|roust
tory|troy
tot|ott
totalled|allotted
totem|motet
toter|torte|otter
touch|couth
tough|ought
toughs|sought
tour|rout
toured|detour|routed
tourer|router
tours|routs|torus|roust
tousle|solute
tousled|loudest
tousles|solutes
tow|two
towel|owlet
towels|lowest
tower|wrote
town|won't|wont
tows|twos|stow
trace|cater|crate|caret|carte|react
traced|carted|redact
tracer|crater
tracers|craters
traces|recast|crates|caster|reacts
tracing|carting|crating
trade|tread|dater|rated
traded|darted
trader|tarred|darter|retard
traders|starred|retards
trades|treads|stared
trading|darting
trail|trial
trailer|retrial
trails|trials
traipse|parties|pastier|pirates
traits|artist|strait
tram|mart
tramline|terminal
trance|canter|nectar|cretan|recant
transept|patterns
transit|tristan
transite|nitrates
transom|matrons
transpose|patroness
trap|part|rapt|tarp
trashed|threads|hardest
traumas|sumatra
travel|varlet
travels|varlets
tray|arty
trays|satyr|stray
treacle|electra
tread|dater|rated|trade
treader|retread
treading|gradient
treadle|altered|related|alerted
treads|trades|stared
treason|senator
treat|tetra|tater
treater|retreat
treaties|iterates|treatise
treatise|treaties|iterates
treats|taster|stater
treed|deter
treeing|integer
trees|terse|ester|steer|reset
trefoil|loftier
trendier|interred
tress|rests
tressed|dessert|deserts
trestle|settler|letters
trestles|settlers
trial|trail
trials|trails
tribe|tiber|biter
tribes|bestir|bister
tribune|turbine
tribunes|turbines
tried|rited|tired
tries|rites|tires|tiers
trifling|flirting
trig|girt|grit
trimmed|midterm
trindle|tendril
trinket|knitter
trio|riot|tori
triode|editor|rioted
trios|riots
tristan|transit
triter|ritter
triune|uniter
trolls|stroll
troop|porto
trooped|torpedo
trot|tort
trounce|counter|recount
trounces|recounts|counters|construe
troupe|puerto|pouter
troupes|spouter|posture
trout|tutor
trouts|tutors
trouty|tryout
trove|voter|overt
troy|tory
truce|cruet|cuter|curet
trucks|struck
truest|utters
truffle|fretful
trumpets|strumpet
trust|strut
truster|struter|turrets
trusts|struts
truths|thrust
tryout|trouty
tsar|tars|arts|star|rats
tsarina|artisan
tsarist|artists|straits
tsars|stars
tub|btu|but
tuba|tabu|abut
tubed|debut
tuber|rebut|brute|buret
tubers|brutes|buster
tubs|stub|bust
tucson|counts
tug|gut
tugs|gust|guts
tulane|lunate
tulsa|latus|sault|talus
tumbler|tumbrel
tumblers|stumbler
tumbles|stumble
tumbrel|tumbler
tun|nut
tuna|aunt
tunas|aunts
tunes|unset
tunis|units
tuple|letup
turbine|tribune
turbines|tribunes
turk|kurt
turn|runt
turndown|downturn
turner|return
turnover|overturn
turnup|upturn
turrets|struter|truster
tush|huts|shut|thus
tutor|trout
tutors|trouts
twiner|winter
twinges|stewing
twit|witt
two|tow
twos|tows|stow
typhon|python
typos|topsy
tyson|stony
ucla|caul
ugh|hug
uglily|gluily
ulan|ulna
ulcer|lucre|cruel
ulna|ulan
ulnar|lunar
ultimate|mutilate
umlaut|mutual
umpire|impure
un|nu
unable|nebula
unarmed|manured
unbred|burden|burned
unburden|unburned
unburned|unburden
unclear|nuclear
undated|daunted
underdog|grounded
underfed|refunded
undergo|guerdon
unearth|haunter
unesco|ounces
unfelt|fluent
unions|unison
unison|unions
unite|untie
united|untied
uniter|triune
unites|unties
units|tunis
univac|vicuna
unlisted|insulted
unlit|until
unloaded|duodenal
unman|annum
unmated|untamed
unnamed|mundane
unpile|lupine|lineup
unreal|neural|lauren
unset|tunes
unshod|hounds|hudson
unsoiled|delusion
unstated|untasted
untamed|unmated
untasted|unstated
untie|unite
untied|united
unties|unites
until|unlit
untimely|minutely
untried|intrude
unwary|runway
uphold|holdup
upholds|holdups
upland|dunlap
uppers|supper
upraise|piraeus
ups|pus|sup
upset|setup
upsets|setups
upsilon|pulsion
upstand|dustpan
uptime|impute
uptrend|prudent
upturn|turnup
upwind|windup
uranyl|lunary
urges|surge
urgings|surging
urn|run
urns|runs
ursine|insure|inures
use|sue
used|deus|dues|sued
user|suer|ruse|rues|sure
uses|sues
ushers|rushes|rhesus
using|suing
ussr|russ
usurped|pursued
usurper|pursuer
usurping|pursuing
uterine|retinue|reunite
uterus|suture
utters|truest
uveal|value
vacate|caveat
vacates|caveats
vacuolate|autoclave
vade|dave|deva|veda
vaguest|gustave
vail|vial
vain|ivan
vale|veal|lave
valence|enclave
valences|enclaves
valine|veinal|venial
valois|violas
value|uveal
vane|nave
vanes|evans
variac|caviar
various|saviour
varlet|travel
varlets|travels
vase|save
vases|saves
vaster|starve
veal|vale|lave
vector|covert
veda|vade|dave|deva
veer|ever
veers|verse|serve|sever
veery|every
vega|gave
veil|vile|evil|levi|live
veiled|levied
veils|lives|evils|levis
vein|vine
veinal|valine|venial
veined|envied|endive
veinous|envious
veins|vines
velar|laver|ravel
velour|louver|louvre
venal|navel
vender|denver|nerved
veneer|evener
venerate|enervate
venetian|aventine
venial|veinal|valine
venice|evince
vera|aver|rave
verbose|observe|obverse
verdi|drive|diver
verily|livery
verlag|gravel
vermin|mervin
verna|raven
verne|nerve|never
vernier|nervier
versa|saver|raves
verse|serve|veers|sever
versed|served
verser|server
verses|severs|serves
version|iverson
vessel|selves
veto|vote
vetoed|devote
vetos|votes|stove
vial|vail
vicuna|univac
vida|avid|diva
vide|vied|dive
vie|i've
vied|dive|vide
vies|vise
view|wive
viewer|review
viewers|reviews
views|wives
vigor|virgo
vile|evil|veil|levi|live
vilely|lively|evilly
vileness|evilness
viler|livre|liver
vine|vein
vines|veins
viola|voila
violas|valois
violated|dovetail
viperous|previous
viral|rival
virgo|vigor
visa|avis|siva
vise|vies
vised|dives
visored|devisor
viva|aviv
vocate|avocet|octave
void|ovid
voided|devoid
voila|viola
vortices|evictors
vote|veto
voter|trove|overt
voters|strove
votes|vetos|stove
vowel|wolve
vowels|wolves
vreeland|lavender
wabash|bashaw
wac|caw
wadder|drawed|edward
waddle|dawdle
waddled|dawdled
waddler|dawdler|drawled
waddles|swaddle|dawdles
waddling|dawdling
wade|awed
wader|dewar
wages|swage
wagner|gnawer
wags|swag
wah|haw
waist|waits
waiters|wariest
waits|waist
wake|weak
waker|wreak
wakes|askew
waldron|rowland
wale|weal
walsh|shawl
walters|wastrel
wan|awn
wand|dawn
wander|andrew|warden|warned
wanders|wardens|andrews
wane|anew|wean
wang|gnaw
waning|awning
wants|wasn't
war|raw
warble|bawler
ward|draw
warden|andrew|wander|warned
wardens|wanders|andrews
wards|draws
ware|wear
wares|wears|swear|sawer
wariest|waiters
warm|mawr
warms|swarm
warned|andrew|warden|wander
warp|wrap
warper|prewar
warps|wraps
warred|reward|redraw|drawer
wars|raws
warts|swart|straw
wary|awry
was|saw
wash|shaw
washout|outwash
wasn't|wants
wast|swat
waste|sweat
waster|waters|rawest
wastes|sweats
wastrel|walters
waters|rawest|waster
way|yaw
ways|sway|yaws
wayside|sideway
waysides|sideways
we'd|dew|wed
we'll|well
we're|ewer|were
weak|wake
weal|wale
wealthy|whatley
wean|wane|anew
wear|ware
weariest|sweatier
wears|swear|wares|sawer
weather|wreathe|whereat
wed|dew|we'd
weds|dews
wee|ewe
weeps|sweep
weir|wier|wire
weird|wired|wider
weirdos|dowries|rowdies
weld|lewd
well|we'll
wells|swell
welts|swelt
went|newt
were|ewer|we're
west|stew|wets
wets|stew|west
whalen|whelan
what|thaw
what're|wreath
whatley|wealthy
whats|thaws|swath
wheedle|wheeled
wheeled|wheedle
whelan|whalen
when|hewn
where|hewer
whereat|weather|wreathe
whereon|nowhere
whines|newish
whirlies|wilshire
whit|with
white|withe
whiter|writhe|wither
who|how
whoever|however
whomsoever|whomsoever
whosoever|howsoever
widely|wieldy|dewily
widen|edwin|wined
wideness|dewiness
wider|wired|weird
wieldy|widely|dewily
wieners|newsier
wier|weir|wire
wiggler|wriggle
wigs|swig
wildness|swindles|windless
wiles|lewis
wiley|wylie
wills|swill
wilshire|whirlies
winder|rewind
winders|rewinds
windless|swindles|wildness
windup|upwind
wined|edwin|widen
wines|sinew|swine
winged|dewing
wings|swing
wingspan|spawning
winter|twiner
wire|wier|weir
wired|wider|weird
wires|wiser
wiser|wires
with|whit
withe|white
wither|writhe|whiter
withers|writhes
witt|twit
witted|dewitt
wive|view
wives|views
wo|ow
woe|owe
woes|owes
wolve|vowel
wolves|vowels
won|now|own
won't|town|wont
wong|gown
wont|won't|town
woodhen|hoedown
woodland|download
woops|swoop
wop|pow
wordier|worried|rowdier
wordily|rowdily
wordy|dowry|rowdy
wore|rowe
worker|rework
workers|reworks
workout|outwork
wormed|deworm
worried|wordier|rowdier
worse|sower|swore
worsen|owners
worser|rowers
worth|throw
wrap|warp
wraps|warps
wreak|waker
wreath|what're
wreathe|weather|whereat
wrest|strew
wrestle|swelter
wriggle|wiggler
writhe|wither|whiter
writhes|withers
wrong|grown
wrote|tower
wylie|wiley
ya|ay
yacht|cathy
yah|hay
yak|kay
yam|may|amy
yang|nagy
yap|pay
yard|dray
yarn|nary|ryan
yarrow|arrowy
yates|yeast|yeats
yaw|way
yaws|sway|ways
yea|aye
year|eyra|aery
years|sayer|ayers
yeast|yates|yeats
yeats|yates|yeast
yell|lyle
yelp|pyle
yemen|enemy
yo|oy
yodel|doyle
yowl|owly
zap|paz
zeal|laze
zeiss|sizes
zeus|suez
zoa|azo